XXXXXXXXXXXXXXXXXXXXXXXXXXXXXXXXXXXXXXXXXXXXXXXXXXXXXXXXXXXXXXXXXXXXXXXXXXXXXXXXXXXXXXXXXXXXXXXXXXXX
X XXXXXXXXXXXXXXXXXXXX XXXXXXX XXXXXX XXXXXXXXXXXXXXXXXXXX XXX XXXXXXXXXX XXXXXXXXXXX XXX XXXXXXXX X
X XXXXXXXXXXXXXXXXXXXX XXXXXXX XXXXXX             e                                   XXX XXXXXXXX X
X XXXXXXXXXXXXXXXXXXXX XXXXXXX XXXXXX XXXXXXXXXXXXXXXXXXXX XXX XXXXXX XXX XXXXXXXXXXX XXX XXXXXXXX X
X XXXXXXXXXXXXXXXXXXXX XXXXXXX XXXXXX XXXXXXXXXXXXXXXXXXXX XXX XXXXXX  XX XXXXXXXXXXX XXX XXXXXXXX X
X  XXXXXXXXXXXXXXXXXXX XXXXXXX XXXXXX XXXXXXXXXXXXXXXXXXXX XXX XXXXXX     XXXXXXXXXXX XXX XXXXXXXX X
X                      XXXXXXX XXXXXX XXXXXXXXXXXXXXXXXXXX XXX XXXXXX  XX XXXXXXXXXXX XXX XXXXXXXX X
X  XXXXXXXXXXXXXXXXXXX XXXXXXX XXXXXX XXXXXXXXXXXXXXXXXXXX XXX XXXXXX XXX XXXXXXXXXXX XXX XXXXXXXX X
X XXXXXXXXXXXXXXXXXXXX XXXXXXX XXXXXX XXXXXXXXXXXXXXXXXXXX XXX XXXXXX XXX XXXXXXXXXXX XXX XXXXXXX  X
X  XXXXXXXXXXXXXXXXXXX XXXXXXX XXXXXX XXXXXXXXXXXXXXXXXXXX XXX XXXXXX XXX XXXXXXXXXXX              X
X                              XXXXXX XXXXXXXXXXXXXXXXXXXX XXX XXXXXX XXX XXXXXXXXXXX XXX XXXXXXX  X
XXXXXXXXXXXXXXXXXXXXXX XXXXXXX XXXXXX XXXXXXXXXXXXXXXXXXXX XXX XXXXXX XXX XXXXXXXXXXX XXX XXXXXXXX X
XXXXXXXXXXXXXXXXXXXXXX XXXXXXX XXXXXX XXXXXXXXXXXXXXXXXXXX XXX XXXXXX XXX XXXXXXXXXXX XXX XXXXXXXX X
XXXXXXXXXXXXXXXXXXXXXX XXXXXXX XXXXX   XXXXXXXXXXXXXXXXXXX XX  XXXXXX XXX XXXXXXXXXXX XXX XXXXXXXX X
X                                                                                                  X
X XXXX XXXXXXX XXXXXX XXXXXXXX XXXXXXXXXXXXXXXXXXXXXX XXXX XX XXXXXXX XXXXXXXXXXXX XX XXXXXXXXXXXX X
X XXXX XXXXXXX XXXXXX XXXXXXXX XXXXXXXXXXXXXXXXXXXXXX XXXX XX XXXXXXX XXXXXXXXXXXX XX XXXXXXXXXXXX X
X                              XXXXXXXXXXXXXXXXXXXXXX                 XXXXXXXXXXXX XX XXXXXXXXXXXX X
X XXXX XXXXXXX XXXXXX XXXXXXXX XXXXXXXXXXXXXXXXXXXXXX XXXX XXXXXXXXXX XXXXXXXXXXXX XX XXXXXXXXXXXX X
XaXXXX XXXXXXX XXXXXX XXXXXXXX XXXXXXXXXXXXXXXXXXXXXX XXXX XXXXXXXXXX XXXXXXXXXXXX XX XXXXXXXXXXXX X
X XXXX XXXXXXX XXXXXX XXXXXXXX XXXXXXXXXXXXXXXXXXXXXX XXXX XXXXXXXXXX XXXXXXXXXXXX XX XXXXXXXXXXXX X
X XXXX XXXXXXX                                        XXXX XXXXXXXXXX                 XXXXXXXXXXXX X
X              XXXXXXX XXXXXXX XXXXXXX XXX XXXXX   XX XXXX XXXXXXXXXX XXXXXXXXXXXX XX XXXXXXXXXXXX X
X XXXXXXXXXXXX XXXXXXX XXXXXXX XXXXXXX XXX XXXXXX XXX XXXX XXXXXXXXXX XXXXXXXXXXXX XX XXXXXXXXXXXX X
X XXXXXXXXXXXX XXXXXXX XXXXXXX XXXXXXX XXX XXXXXX XXX XXXX XXXXXXXXXX XXXXXXXXXXXX XX XXXXXXXXXXXX X
X XXXXXXXXXXXX XXXXXXX XXXXXXX                    XXX XXXX XXXXXXXXXX XXXXXXXXXXXX XX XXXXXXXXXXXX X
X XXXXXXXXXXXX                 XXX XXX XX  XX   X XXX                                              X
X XXXXXXXXXXXX XXXXXXX XXXXXXX XXX XXX XX XXXX XX XXX XXXXXXXXXXXXXXX XXXXXXXX XXXXXX XXX XXX XXXX X
X XXXXXXXXXXXX XXXXXXX XXXXXXX XXX XXX XX  XXX XX XXX XXXXXXXXXXXXXXX XXXXXXXX XXXXXX XXX XXX XXXX X
X XXXXXXXXXXXX XXXXXXX XXXXXXX XXX XXX XX         XXX XXXXXXXXXXXXXXX XXXXXXXX XXXXXX      XX XXXX X
X XXXXXXXXXXXX XXXXXXX XXXXXXX XXX XXX XX  XXXXXX                     XXXXXXXX XXXXXX XXX          X
X XXXXXXXXXXXX XXXXXXX XXXXXXX XXX XXX XX XXXXXXX XXX XXXXXXXXXXXXXXX XXXXXXXX XXXXXX XXX XXX XXXX X
X XXXXXXXXXXXX XXXXXXX XXXXXXX XXX XXX XX XXXXXXX XXX  XXXXXXXXXXXXXX XXXXXXXX XXXXXX XXX XXX XXXX X
X                              XXX XXX            XXX                 XXXXXXXX XXXXXX XXX XXX XXXX X
X XXXX XXX XXX XX XXXXXXX XXXX         XX XXXXXXX XXX  XXXXXXXXXXXXXX XXXXXXXX XXXXXX XXX XXX XXXX X
X XXXX XXX XXX XX XXXXXXX XXXX XXX XXX XX XXXXXXX XXX XXXXXXXXXXXXXXX XXXXXXXX XXXXXX XXX XXX XXXX X
X XXXX XXX XXX XX XXXXXXX XXXX XXX XXX XX XXXXXXX XXX  XXXXXXXXXXXXXX XXXXXXXX XXXXXX XXX XXX XXXX X
X XXXX XXX XXX XX XXXXXXX XXXX XXX XXX XX XXXXXXX  XX                 XXXXXXXX XXXXXX XXX XXX XXXX X
X XXXX XXX XXX XX XXXXXXX XXXX XXX XXX XX XXXXXXX      XXXXXXXXXXXXXX XXXXXXXX XXXXXX XXX XXX XXXX X
X XXXX XXX XXX XX XXXXXXX XXXX XXX XXX XX XXXXXXX  XX XXXXXXXXXXXXXXX XXXXXXXX XXXXXX XXX XXX XXXX X
X XXXX XXX XX  XX XXXXXXX XXXX XXX XXX XX XXXXXXX XXX XXXXXXXXXXXXXXX XXXXXXXX XXXXXX XXX XXX XXXX X
X XXXX XXX     XX XXXXXXX XXXX XXX XXX XX XXXXXXX XXX XXXXXXXXXXXXXXX XXXXXXXX XXXXXX  XX XXX XXXX X
X XXXX XXX XX  XX XXXXXXX XXXX XXX XXX XX XXXXXXX XXX XXXXXXXXXXXXXXX                     XXX XXXX X
X XXXX XXX XXX XX XXXXXXX XXXX XXX XXX XX XXXXXXX XXX XXXXXXXXXXXXXXX XXXXXXXXcXXX XX  XX XXX XXXX X
X XXXX XXX XXX XX XXXXXXX XXXX XXX XXX XX XXXXXXX XXX XXXXXXXXXXXXXXX XXXXXXXX XXX XX XXX XXX XXXX X
X XXXX XXX XXX XX XXXXXXX XXXX                                                             d  XXXXCX
X          XXX XX XXXXXXX XXXX XXX XXXXXXXXXXXXXXXXXX XXX XXXX XXXXXXXXXXXXXXX XX  XX XXX XXX XXXX X
X XXXX XXX XXX XX XXXXXXX XXXX XXX XXXXXXXXXXXXXXXXXX XXX XXXX XXXXXXXXXXXXXXX XX XXX XXX XXX XXXX X
X XXXX XX  XXX XX XXXXXXX XXXX XXX XXXXXXXXXXXXXXXXXX XXX XXXX XXXXXXXXXXXXXXX XX XXX XXX XXX XXXX X
X XXXX     XXX XX XXXXXXX XXXX                        XXX XXXX XXXXXXXXXXXXXXX XX XXX XXX XXX XXXX X
X XXXX XX  XXX XX              XXX XXXXXX XXXXXXXXXXX          XXXXXXXXXXXXXXX XX         XXX XXXX X
X XXXX XXX XXX XX XXXXXXX XXXX XXX XXXXXX XXXXXXXXXXX XXX XXXX XXXXXXXXXXXXXXX XX XXX XXX XXX XXXX X
X XXXX XXX XXX XX XXXXXXX XXXX XXX XXXXXX XXXXXXXXXXX XXX XXXX XXXXXXXXXXXXXXX XX XXX XXX XXX XXXX X
X XXXX XXX XXX XX XXXXXXX XXXX XXX XXXXXX XXXXXXXXXXX  XX  XXX XXXXXXXXXXXXXXX XX XXX XXX XXX XXXX X
X          XXX XX XXXXXXX XXXX XXX XXXXXX XXXXXXXXXXX          XXXXXXXXXXXXXXX XX XXX              X
X XXXXXXXX XXX XX XXXXXXX XXXX XXXEXXXXXX XXXXXXXXXXX  XX  XXX XXXXXXXXXXXXXXX XX XXX XXX XXXXXXXX X
X XXXXXXXX XXX XX XXXXXXX XXXX XXX XXXXXX XXXXXXXXXXX  XX XXXX XXXXXXXXXXXXXXX XX XXX XXX XXXXXXXX X
X              XX XXXXXXX XXXX XXX XXXXXX XXXXXXXXXXX   X XXXX XXXXXXXXXXXXXXX XX XXX XXX XXXXXXXX X
XXXXX   XX XXX                 XXX XXXXXX XXXXXXXXXXX                                              X
XXXXXX XXX XXX XX XXXXXXXXXXXX XXX XXXXXX XXXXXXXXXXX XXX XXXX XXXXXXXXXXXXXXX XX XXX XXXXXXXXXXXX X
XXXXXX XXX XXX XX XXXXXXXXXXXX XXX XXXXXX XXXXXXXXXXX XXX XXXX XXXXXXXXXXXXXXX XX XXX XXXXXXXXXXXX X
XXXXXX XXX XXX XX XXXXXXXXXXXX XXX XXXXX   XXXXXXXXXX XXX XXX   XXXXXXXXXXXXXX XX XXX XXXXXXXXXXXX X
X                                                      B                                           X
X XXXXXXX XXXXXXXXXXX XXXXXXXXXXXXXXXXXXXXXXXXXXX XXXXXXXXXXXXXXXXXXXXXXX XXXXXXX  XX XXXXXXX XXXXXX
X XXXXXXX XXXXXXXXXXX  XXXXXXXXXXXXXXXXXXXXXXXXXX XXXXXXXXXXXXXXXXXXXXXXX XXXXXXXX XX XXXXXXX XXXXXX
X                                                                                  XX XXXXXXX XXXXXX
X XXXXXXX XXXXXXXXXXX  XXXXXXXXXXXXXX   XXXXXXXXX XXXXXXXXXXXXXXXXXXXXXXX XXXXXXXX XX XXXXXXX XXXXXX
X XXXXXXX XXXXXXXXXXX XXXXXXXXXXXXXXXX XXXXXXXXXX XXXXXXXXXXXXXXXXXXXXXXX XXXXXXXX XX XXXXXXX XXXXXX
X XXXXXXX XXXXXXXXXXX XXXXXXXXXXXXXXXX XXXXXXXXXX XXXXXXXXXXXXXXXXXXXXXXX XXXXXXX  XX XXXXXXX XXXXXX
X XXXXXXX XXXXXXXXXXX                                                              XX XXXXXXX XXXXXX
X                     XXXXXXXXXXXXXXXXXXXXXXXXXXX XXXXXXXXXXXXXXXXXXXXXXXXXX   XX  XX XXXXXXX XXXXXX
X XXXXXXXXXXXXXXXXXXX XXXXXXXXXXXXXXXXXXXXXXXXXXX XXXXXXXXXXXXXXXXXXXXXXXXXXX XXXX XX XXXXXXX XXXXXX
X XXXXXXXXXXXXXXXXXXX XXXXXXXXXXXXXXXXXXXXXXXXXXX XXXXXXXXXXXXXXXXXXXXXXXXXXX XXXX XX XXXXXXX XXXXXX
X XXXXXXXXXXXXXXXXXXX XXXXXXXXXXXXXXXXXXXXXXXXXX   XXXXXXXXXXXXXXXXXXXXXXXXXX XXXX XX XXXXXXX XXXXXX
X                                                                                  XX XXXXXXX XXXXXX
XXXXX XXXXXXXXXXXXXXX XXXXXXXXXXXXXXXXXXXX XXXXXXXXXXXXXXXXXXXXXXXXXXXXXXXXXXXXXXX XX XXXXXXX XXXXXX
XXXXX XXXXXXXXXXXXXXX XXXXXXXXXXXXXXXXXXXX XXXXXXXXXXXXXXXXXXXXXXXXXXXXXXXXXXXXXXX XX XXXXXXX XXXXXX
XXXXX XXXXXXXXXXXXXXX XXXXXXXXXXXXXXXXXXXX XXXXXXXXXXXXXXXXXXXXXXXXXXXXXXXXXXXXXXX XX XXXXXXX XXXXXX
XXXXX XXXXXXXXXXXXXXX XXXXXXXXXXXXXXXXXXXX XXXXXXXXXXXXXXXXXXXXXXXXXXXXXXXXXXXXXXX XX XXXXXXX XXXXXX
XXXXX XXXXXXXXXXXXXXX XXXXXXXXXXXXXXXXXXXX XXXXXXXXXXXXXXXXXXXXXXXXXXXXXXXXXXXXXXX XX XXXXXXX XXXXXX
XXXXX XXXXXXXXXXXXXXX XXXXXXXXXXXXXXXXXXXX XXXXXXXXXXXXXXXXXXXXXXXXXXXXXXXXXXXXXXX XX XXXXXXX XXXXXX
XXXXX XXXXXXXXXXXXXXX                                                              XX XXXXXXX XXXXXX
X                     XXX   XXXXXXXXXXXXXX XXXXXXXXXXX XXXXXXXXXXXXXXXXXXXXXXXXXXX XX XXXXXXX XXXXXX
XXXXX XXXXXXXXXXXXXXX XXXX XXXXXXXXXXXXXXX XXXXXXXXXXX XXXXXXXXXXXXXXXXXXXXXXXXXXX XX XXXXXXX XXXXXX
XXXXX XXXXXXXXXXXXXXX XXXX XXXXXXXXXXXXXXX XXXXXXXXXXX XXXXXXXXXXXXXXXXXXXXXXXXXXX XX XXXXXXX XXXXXX
X                                                                                     XXXXXXX XXXXXX
XXXXXXXXXXXXXXXXXX XXXXX   XXXXXX   XXXXXX XXXXXXXXXXX XXXXXXXXXXX XXXXXXXXXXXXXXX X          XXXXXX
XXXXXXXXXXXXXXXXXX XXXXXX XXXXXXXX XXXXXXX XXXXXXXXXXX XXXXXXXXXXX XXXXXXXXXXXXXXX XX XXXXXXX XXXXXX
XXXXXXXXXXXXXXXXXX XXXXXX XXXXXXXX XXXXXXX XXXXXXXXXXX XXXXXXXXXXX XXXXXXXXXXXXXXX XX XXXXXXX XXXXXX
X                                                                                  XX              X
XXXXXXXXXX XXXXXXX XXXXX   XXXXXXXXXXXXXXX XXXXXXXXXXXXXXX XXXXXXX XXXXXXXXXX XXXX XX XXXXXXX XXX XX
XXXXXXXXXX XXXXXXX XXXXXX XXXXXXXXXXXXXXXX XXXXXXXXXXXXXXX XXXXXXX XXXXXXXXXX XXXX XX XXXXXXX XXX XX
XXXXXXXXXXAXXXXXXX XXXXXX XXXXXXXXXXXXXXXX XXXXXXXXXXXXXXX XXXXXXX XXXXXXXXXX XXXX XX XXXXXXX XXX XX
X                T XXXXXX XXXXXXXXXXXXXXXX XXXXXXXXXXXXXXX XXXXXXX                 XX XXXXXXX XXX XX
XXXXXXXXXX XXXXXXX XXXXXX XXXXXXXXXXXXXXXX                         XXXXXXXXXX XXXX XX XXXXXXX      X
XXXXXXXXXX XXXXXXX XXXXXX XXXXXXXXXXXXXXXX XXXXXXXXXXXXXXX XXXXXXX XXXXXXXXXX XXXX XX XXXXXXX XXX XX
XXXXXXXXXX XXXXXXX XXXXXX XXXXXXXXXXXXXXXX XXXXXXXXXXXXXXX XXXXXXX XXXXXXXXXX XXXX XX XXXXXXX XXX XX
XXXXXXXXXX XXXXXX bXXXXXX XXXXXXXXXXXXXXXX XXXXXXXXXXXXXXX XXXXXXX XXXXXXXXXX XXXX XX XXXXXXX XXX  X
X                  XXXXXX XXXXXXXXXXXXXXXX XXXXXXXXXXXXXXX XXXXXXX XXXXXXXXXX XXXX XX XXXXXXX XXXD X
XXXXXXXXXXXXXXXXXXXXXXXXXXXXXXXXXXXXXXXXXXXXXXXXXXXXXXXXXXXXXXXXXXXXXXXXXXXXXXXXXXXXXXXXXXXXXXXXXXXX