XXXXXXXXXXXXXXXXXXXXXXXXXXXXXXXXXXXXXXXXXXXXXXXXXXXXXXXXXXXXXXXXXXXXXXXXXXXXXXXXXXXXXXXXXXXXXXXXXXXX
XXXXXXXXX XXXX XXX XXXXXXXXXX XXXXXXX XXXX XXX XXXXXXXXXXX            XXXXXXXXXXXXXXXXXXX XXX XXXX X
XXXXXXXXX XXXX                XXXXXXX XXXX XXX XXXXXXXXXXX XX XXXXXXX XXXXXXXXXXXXXXXXXXX XXX XXXX X
XXXXXXXXX XXXX XXX XXXXXXXXXX XXXXXXX XXXX XXX XXXXXXXXXXX XX XXXXXXX XXXXXXXXXXXXXXXXXXX XXX XXXX X
XXXXXXXXX XXXX XX  XXXXXXXXXX XXXXXXX XXXX XXX XXXXXXXXXXX XX XXXXXXX XXXXXXXXXXXXXXXXXXX XXX XXXX X
XXXXXXXXX XXXX     XXXXXXXXXX XXXXXXX XXXX XXX XXXXXXXXXXX XX XXXXXXX XXXXXXXXXXXXXXXXXXX XXX XXXX X
XXXXXXXXX XXXX XX  XXXXXXXXXX XXXXXXX XXXX                    XXXXXXX XXXXXXXXXXXXXXXXXXX XXX XXXX X
XXXXXXXXX XXXX XXX XXXXXXXXXX XXXXXXX XXXX XXX XXXXXXXXXXX XX XXXXXXX XXXXXXXXXXXXXXXXXXX XXX XXXX X
XXXXXXXXX XXXX XXX XXXXXXXXXX XXXXXXX XXXX XXX XXXXXXXXXXX XX XXXXXXX XXXXXXXXXXXXXXXXXXX XXX XXXX X
XXXXXXXXX XXXX XXX XXXXXXXXXX XXXXXXX XXXX XXX XXXXXXXXXXX XX XXXXXXX XXXXXXXXXXXXXXXXXXX XXX XXXX X
XXXXXXXXX XXXX XXX XXXXXXXXXX              XXX XXXXXXXXXXX XX XXXXXXX XXXXXXXXXXXXXXXXXXX XXX XXXX X
XXXXXXXXX XXXX XXX XXXXXXXXXX XXXXXXX XXXX XXX XXXXXXXXXXX XX XXXXXXX XXXXXXXXXXXXXXXXXXX XXX XXXX X
XXXXXXXXX XXXX XXX XXXXXXXXXX XXXXXXX XXXX XXX XXXXXXXXXXX XX XXXXXXX XXXXXXXXXXXXXXXXXXX XXXAXXX  X
XXXXXXXXX XXXX XXX XXXXXXXXXX XXXXXXX XXXX XXX XXXXXXXXXXX XX XXXXXXX XXXXXXXXXXXXXXXXXXX XXX      X
XXXXXXXXX XXXX XXX XXXXXXXXXX                              XX XXXXXXX XXXXXXXXXXXXXXXXXXX XXX XXX  X
XXXXXXXXX XXXX XXX XXXXXXXXXX XXXXXXXXXXXX XXXXXXXXXXXXXXX XX XXXXXXX XXXXXXXXXXXXXXXXXXX XXX XXXX X
XXXXXXXXX XXXX XXX XXXXXXXXXX XXXXXXXXXXXX XXXXXXXXXXXXXXX XX XXXXXXX XXXXXXXXXXXXXXXXXXX XXX XXXX X
X              XXX XXXXXXXXXX  XXXXXXXXXXX XXXXXXXXXXXXXXX XX XXXXXXX XXXXXXXXXXXXXXXXXXX XXX XXXX X
XXXXXXXXX XXXX XXX XXXXXXXXXX                              XX XXXXXXX XXXXXXXXXXXXXXXXXXX          X
XXXXXXXXX XXXX XXX XXXXXXXXXX  XXX XXXXXXXXXX XXXXXXXXXXXX XX XXXXXXX XXXXXXXXXXXXXXXXXXX XXX XXXX X
XXXXXXXXX XXXX XXX XXXXXXXXXX XXXX XXXXXXXXXX XXXXXXXXXXX  XX XXXXXXX XXXXXXXXXXXXXXXXXXX XXX XXX  X
XXXXXXXXX  XXX XXX XXXXXXXXXX XXX  XXXXXXXXXX              XX XXXXXXX XXXXXXXXXXXXXXXXXXX XXX      X
XXXXXXXXX      XXX XXXXXXXXXX                  XXXXXXXXXX                                 XXX XXXd X
XXXXXXXXX  XXX XXX XXXXXXXXXX XXX  XXXXXXXXXX XXXXXXXXXXXX XXX XXXXXX XXXXXXXXXXXXXXXXXXX XXX XXXX X
XXXXXXXXX XXXX XXX XXXXXXXXXX XXXX XXXXXXXXXX XXXXXXXXXXXX XXX XXXXXX  XXXXXXXXXXXXXXXXXX XXX XXXX X
XXXXXXXXX XXXX XXX XXXXXXXXX       XXXXXXXXXX                  XXXXXX                     XXX XXXX X
X                             XXXX XXXXXXXXXX XXXXXXXXXXXX XXX XXXXXX  XXXXXXXXXXXXXXXXXX XXX XXXX X
XXXXXXXXXXXXXX XXXXXX XXXX XX XXXX XXXXXXXXXX XXXXXXXXXXXX XXX XXXXXX XXXXXXXXXXXXXXXXXXX XXX XXXX X
XXXXXXXXXXXXXX XXXXXX XXXX XX XXXX XXXXXXXXXX DXXXXXXXXXXX XXX XXXXXX XXXXXXXXXXXXXXXXXXX XXX XXXX X
XXXXXXXXXXXXXX XXXXXX XXXX XX XXXX XXXXXXXXXX              XXX XXXXXX  XXXXXXXXXXXXXXXXXX          X
XXXXXXXXXXXXXX             XX XXXX XXXXXXXXXX  XX   XXXXXX XXX XXXXXX                     XXXXXXXX X
XXXXXXXXXXXXXX XXXXXX XXXX XX XXXX XXXXXXXXXX XXXX XXXXXXX XXX XXXXXX  XXX XXXXXXXXXXXXXX XXXXXXXX X
XXXXXXXXXXXXXX XXXXXX XXXX XX XXXX XXXXXXXXXX XXXX XXXXXXX XXX XXXXXX XXXX XXXXXXXXXXXXXX  XXXXXXX X
XXXXXXXXXXXXXX XXXXXX XXXX XX XXXX XXXXXXXXXX XXXX XXXXXXX XXX XXXXXX XXXX XXXXXXXXXXXXXX          X
XXXXXXXXXXXXXX XXXXXX XXXX XX XXXX XXXXXXXXXX XXXX XXXXXXX                                 XX   XX X
XXXXXXXXXXXXXX XXXXXX XXXX XX XXXX XXXXXXXXXX XXXX XXXXXXX XXX XXXXXX XXXX XXXXXXXXXXXXXX XXXX XXX X
XXXXXXXXXXXXXX XXXXXX XXXX XX XXXX XXXXXXXXXX XXXX XXXXXXX XXX XXXXXX  XXX XXXXXXXXXXXXXX XXXX XXX X
XXXXXXXXXXXXX  XXXXXX XXXX XX                              XXX XXXXXX                     XXXX XXX X
X              XXXXXX XXXX XX XXXX XXXXXXXXXX XXXXXXXXXXXX XXX XXXXXX  XXXXXXXXXX   XXXXX XXXX XXX X
XXXXXXXXX XXX  XXXXXX XXXX XX XXXX XXXXXXXXXX XXXXXXXXXXXX XXX XXXXXX XXXXXXXXXXXX XXXXXX XXXX XXX X
XXXXXXXXX XXXX XXXXXX XXXX XX XXXX XXXXXXXXXX XXXXXXXXXXXX XXX XXXXXX XXXXXXXXXXXX XXXXXX XXXX XXX X
XXXXXXXXX XXXX XXXXXX XXXX XX XXXX XXXXXXXXXX XXXXXXXXXXXX XXX XXXXXX XXXXXXXXXXXX XXXXXX XXXX XXX X
XXXXXXXXX XXXX XXXXXX XXXX XX XXXX XXXXXXXXXX                         XXXXXXXXXXXX XXXXXX XXXX XXX X
XXXXXXXXX XXXX XXXXXX XXXX XX XXXX XXXXXXXXXX XXXXXXXXXXXX XXXXXXXXXX XXXXXXXXXXXX XXXXXX XXXX XXX X
XXXXXXXXX XXXX XXXXXX XXXX XX XXXX XXXXXXXXXX XXXXXXXXXXXX XXXXXXXXXX XXXXXXXXXXXX XXXXXX XXXX XXX X
XXXXXXXXX XXXX XXXXXX XXXX XX                                                                      X
XXXXXXXXX XXXX XXXXXX XXXX XX XXXXXXX XXXXXXX   XXXXXXXXXX XXXXXX XXXXXXX XXXXXXXXXXXXXXX XXXXXXXX X
XXXXXXXXX XXXX XXXXXX XXXX XX XXXXXXX XXXXXXXX XXXXXXXXXXX XXXXXX XXXXXXX XXXXXXXXXXXXXXX XXXXXXXX X
XXXXXXXXX XXXX XXXXXX XXXX XX XXXXXXX XXXXXXXX XXXXXXXXXXX XXXXXX XXXXXXX XXXXXXXXXXXXXXX XXXXXXXX X
XXXXXXXXX XXXX XXXXXX XXXX XX XXXXXXX XXXXXXXX XXXXXXXXXXX       b                        XXXXXXXX X
XXXXXXXXX XXXX XXXXXX XXXX XX                              XXXXXX XXXXXXX XXXXXXXXXXXX XX XXXXXXXX X
XXXXXXXXX XXXX XXXXXX XXXX XX XXXXXXX XXXXXXXXXXXX XXX XXX XXXXXX XXXXXXX XXXXXXXXXXXX XX XXXXXXXX X
XXXXXXXXX XXXX XXXXXX XXXX XX XXXXXXX XXXXXXXXXXXX XXX XXX XXXXXX XXXXXXX XXXXXXXXXXXX XX XXXXXXXX X
XXXXXXXXX XXXX XXXXXX XXXX XX XXXXXXX XXXXXXXXXXX   XX XXX XXXXXX XXXXXXX XXXXXXXXXXXX XX XXXXXXXX X
XXXXXXXXX XXXX XXXXXX         XXXXXXXC                     XXXXXX XXXXXXX XXXXXXXXXXXX XX XXXXXXXX X
XXXXXXXXX XXXX XXXXXX XXXX XX XXXXXXX XXXXXXXXXXXXXXXX XXX XXXXXX XXXXXXX XXXXXXXXXXXX XX XXXXXXXX X
XXXXXXXXX XXXX XXXXXX XXXX XX XXXXXXX XXXXXXXXXXXXXXXX XXX XXXXXX XXXXXXX XXXXXXXXXXXX XX XXXXXXXX X
XXXXXXXXX XXXX XXXXXX XXXX XX XXXXXXX XXXXXXXXXXXXXXXX XXX XXXXXX XXXXXXX XXXXXXXXXXXX XX XXXXXXXX X
X                             XXXXXXX XXXXXXXXXXXXXXXX XXX XXXXXX XXXXXXX XXXXXXXXXXXX XX XXXXXXXX X
XXXXXXXXX XXXX XXXXXXXXXXX XX XXXXXXX XXXXXXXXXXXXXXXX XXX XXXXXX XXXXXXX XXXXXXXXXXXX XX XXXXXXXX X
XXXXXXXXX XXXX XXXXXXXXXXX XX XXXXXXX XXXXXXXXXXXXXXXX XXX XXXXXX XXXXXXX XXXXXXXXXXXX XX XXXXXXXX X
X                                                                                         XXXXXXXX X
XXXXXX XXXXXXXXXXXXXXXXXXXXXX XXXXXXXXXXXXXXXXXXXX XXX XXXXXXX XXXXXXXXXXXXX   XXXXXX  XX XXXXXXXX X
XXXXXX XXXXXXXXXXXXXXXXXXXXXX XXXXXXXXXXXXXXXXXXXX XXX XXXXXXX XXXXXXXXXXXXXX XXXXXXX XXX XXXXXXXX X
XXXXXX XXXXXXXXXXXXXXXXXXXXXX XXXXXXXXXXXXXXXXXXXX XXX XXXXXXX XXXXXXXXXXXXXX XXXXXXX XXX XXXXXXXX X
XXXXXX XXXXXXXXXXXXXXXXXXXXXX XXXXXXXXXXXXXXXXXXXX XXX XXXXXXX XXXXXXXXXXXXXX XXXXXX   XX XXXXXXXX X
X                             XXXXXXXXXXXXXXXXXXXX                                        XXXXXXXX X
XXXXXX XXXXXXXXXXXXXXXXXXXXXX XXXXXXXXXXXXXXXXXXXX XXX XXXXXXX XXXXXXXXXXXXXXXXXXXXXXXXXX XXXXXXXX X
XXXXXX XXXXXXXXXXXXXXXXXXXXXX XXXXXXXXXXXXXXXXXXXX XXX XXXXXXX XXXXXXXXXXXXXXXXXXXXXXXXXX XXXXXXXX X
XXXXXX XXXXXXXXXXXXXXXXXXXXXX XXXXXXXXXXXXXXXXXXXX XXX XXXXXXX XXXXXXXXXXXXXXXXXXXXXXXXXX XXXXXXXX X
XXXXXX XXXXXXXXXXXXXXXXXXXXXX XXXXXXXXXXXXXXXXXXXX XXX XXXXXXX XXXXXXXXXXXXXXXXXXXXXXXXXX          X
XXXXXX XXXXXXXXXXXXXXXXXXXXXX XXXXXXXXXXXXXXXXXXXX XXX XXXXXXX XXXXXXXXXXXXXXXXXXXXXXXXXX XXXXXXXX X
XXXXXX XXXXXXXXXXXXXXXXXXXXXX XXXXXXXXXXXXXXXXXXXX XXX XXXXXXX XXXXXXXXXXXXXXXXXXXXXXXXXX XXXXXXXX X
X                                                                                                  X
XXXXXX XXXXX   X   XXXXXXX XX XXXX XXXXXXX XX XXXX XX XXXXXXXXXXXXXXX XXXXXXX   XXXXX XXX XXX XXXXXX
XXXXXX XXXXXX XXX  XXXXXXX XX XXXX XXXXXXX XX XXXX XX XXXXXXXXXXXXXXX XXXXXXX  XXXXXX XXX XXX XXXXXX
XXXXXX XXXXXX XXXX XXXXXX  XX XXXX XXXXXXX XX XXXX XX XXXXXXXXXXXXXXX XXXXXXX XXXXXXX XXX XXX XXXXXX
XXXXXX XXXXXX XXXX         XX XXXX XXXXXXX XX                                         XXX XXX XXXXXX
XXXXXX XXXXXX XXXX XXXXXX  XX XXXX XXXXXXX XX XXXXXXX XXXXXXXXXXXXXXX XXXXXXX XXXXXXX XXX XXX XXXXXX
XXXXXX XXXXXX XXXX XXXXXXX XX XXXX XXXXXXX XX XXXXXXX XXXXXXXXXXXXXXX XXXXXXX XXXXXXX XXX XXX XXXXXX
XXXXXX XXXXXX XXXX XXXXXXX XX XXXX XXXXXXX XX XXXXXXXaXXXXXXXXXXXXXXX XXXXXXX XXXXXXX XXX XXX  XXXXX
XXXXXX XXXXXX XXXX XXXXXXX XX XXXX XXXXXXX XX                                             XXX      X
XXXXXX XXXXXX XXXX XXXXXXX XX              XX XXXXXXXXXXX XXXXXXXXXXXXXXXXXXXXXXXX XX XXX XXX  XX XX
XXXXXX XXXXXX XXXX XXXXXXX XX XXXX XXXXXXX XX XXXXXXXXXXX XXXXXXXXXXXXXXXXXXXXXXXX XX XXX XXX XXX XX
XXXXXX XXXXXX XXXX XXXXXXX XX XXXX XXXXXXX XX XXXXXXXXXXX XXXXXXXXXXXXXXXXXXXXXXXX XX XXX XXX XXX XX
XXXXXX XXXXXX  XXX XXXXXXX                                                            XXX XXX XXX XX
XXXXXX XXXXXX               X XXXXXXXXXXXX XX XX   XXXXXX XXXXXXXXXXXXXXXXXXXXXXXX XX XXX XXX XXX XX
XXXXXX XXXXXX  XXX XXXXXXX XX XXXXXXXXXXXX XX XXX XXXXXXX XXXXXXXXXXXXXXXXXXXXXXXX XX XXX XXX XXX XX
XXXXXX XXXXXX XXXX XXXXXXX XX XXXXXXXXXXXX XX XXX XXXXXXX XXXXXXXXXXXXXXXXXXXXXXXX XXeXXX XXX XXX XX
XXXXXX XXXXXX XXXX XXXXXXX XX XXXXXXXXXXXX X   XX XXXXXXX XXXXXXXXXXXXXXXXXXXXXXXX XXEXXX XXX      X
XXXXXX XXXXXX XXXX                                                                        XXX XXX XX
XXXXXX XXXXXX XXXX XXX XXX XX XXXXXXXXXXXX XXXXXX XXX XXXXXXXXXXXXXXXXXXXX XX XXXXXXXXXXX XXX XXXTXX
XXXXXX XXXXXX XXXX XXX XXX XX XXXXXXXXXXXX XXXXXX XXX XXXXXXXXXXXXXXXXXXXX XX XXXXXXXXXXX XXX XXX XX
XXXXXX XXXXXX XXXX XXX XXX X   XXXXXXXXXXX XXXXXX XXX XXXXXXXXXXXXXXXXXXXX XX XXXXXXXXXXX XXX XXX XX
X                    c    B                                                               XXX XXX XX
XXXXXX XXXXXXX XXX XXX XXXXXXXXXXXXXXXXXXXXXX XXX XXX XXXXXXXXXXXXXXXXXXXX XX XXXXXXXXXXX XXX XXX XX
XXXXXX XXXXXXX XXX XXX XXXXXXXXXXXXXXXXXXXXXX XXX XXX XXXXXXXXXXXXXXXXXXXX XX XXXXXXXXXXX XXX XXX XX
XXXXXX                                                                                             X
X       XXXXXX XXX XXXXXXXXXXXXXXXXXXXXXXXXXX XXXXXXXXXXX   XXXXXXXXXXXXXXXXXXXXXXXXXXXXX XXX XXXXXX
XXXXXXXXXXXXXXXXXXXXXXXXXXXXXXXXXXXXXXXXXXXXXXXXXXXXXXXXXXXXXXXXXXXXXXXXXXXXXXXXXXXXXXXXXXXXXXXXXXXX