XXXXXXXXXXXXXXXXXXXXXXXXXXXXXXXXXXXXXXXXXXXXXXXXXXXXXXXXXXXXXXXXXXXXXXXXXXXXXXXXXXXXXXXXXXXXXXXXXXXX
X                                                                         e                        X
XXXXX XXXX XX XXXXXXX XXXXXXX XXXX XX XXX XXXXXXXX XXXXXX XXXX XXXXXXXXXXXXXXXXXXX XX  XX XXXXXXX XX
XXXXX XXXX XX XXXXXXX XXXXXXX XXXX XX XXX XXXXXXXX XXXXXX XXXX XXXXXXXXXXXXXXXXXXX XX XXX XXXXXXX XX
XXXXX XXXX XX XXXXXXX XXXXXXX XXXX XX XXX XXXXXXX  XXXXXX XXXX XXXXXXXXXXXXXXXXXXX XX XXX XXXXXXX XX
XXXXX XXXX XX                 XXXX XX              XXXXX   XXX XXXXXXXXXXXXXXXXXXX XX XXX XXXXXXX XX
XXXXX XXXX XX XXXXXXX XXXXXXX XXXX XX XXX XXXXXXX                                     XXX XXXXXXX XX
XXXXX XXXX XX XXXXXXX XXXXXXX XXXX XX XXX XXXXXXXX XXXXXX XXXX XXXXXXXXXXXXXXXXXXX XX XXX XXXXXXX XX
XXXXX XXXX XXGXXXXXXX XXXXXXX  XXX XX XXX XXXXXXXX XXXXXX XXXX XXXXXXXXXXXXXXXXXXX XX XXX XXXXXXX  X
XXXXX XXXX XX XXXXXXX XXXXXXX         XXX XXXXXXXX XXXXXX XXXX XXXXXXXXXXXXXXXXXXX XX XXX XXXXXXX  X
XXXXX XXXX XX XXXXXXX XXXXXXX  XXX XX XXX XXXXXXXX                                 XX XXX XXXXXXX  X
XXXXX XXXX XX XXXXXXX XXXXXXX XXXX XX XXX XXXXXXXX XXXXXX XXXXXXXXXXXXXXXXXXXXXXXX XX XXX XXXXXXX XX
XXXXX XXXX XX XXXXXXX XXXXXXX XXXX XX XXX XXXXXXX  XXXXXX XXXXXXXXXXXXXXXXXXXXXXXX XX XXX XXXXXXX XX
XXXXX XXXX XX XXXXXXX XXXXXXX XXXX XX              XXXXXX XXXXXXXXXXXXXXXXXXXXXXX  XX XXX XXXXXXX XX
XXXXX XXXX XX XXXXXXX XXXXXXX XXXX XX XXXXXXXXXXX                                  XX XXX XXXXXXX XX
XXXXX XXXX XX XXXXXXX XXXXXXX XXXX XX XXXXXXXXXXXX XXXXXX XXXXXXXXXXXXXXXXXXXXXXX  XX XXX XXXXXXX XX
XXXXX XXXX XX XXXXXXX XXXXXXX XXXX XX XXXXXXXXXXXX XXXXXX XXXXXXXXXXXXXXXXXXXXXXXX XX XXX XXXXXXX XX
XXXXX XXXX XX XXXXXXX XXXXXXX XXXX XX XXXXXXXXXXXX XXXXX   XXXXXXXXXXXXXXXXXXXXXXX XX XXX  XXXXXX XX
XXXXX XXXX                                                                         XX XXX         XX
XXXXX XXXX XX XXXXXXXXXXX XXX XXXX XX XXX XXXX XXX XX XXXXXXXXXXXXXXXXXXXX XXXXXXX XX XXX  XXXXXX XX
XXXXX XXXX XX XXXXXXXXXXX XXX XXXX XX XXX XXXX XXX XX XXXXXXXXXXXXXXXXXXXX XXXXXXX XX XXX XXXXXXX XX
XXXXX XXXX XX                 XXXX XX XXX XXXX XXX                         XXXXXXX XX XXX  XXXXXX XX
XXXXX XXXX XX XXXXXXXXXXX XXX XXXX XX XXX XXXX XXX XX XXXXXXXXXXXXXX   XXX            XXX         XX
XXXXX XXXX XX XXXXXXXXXXX XXX XXXX XX XXX XXXX XXX XX XXXXXXXXXXXXXXX XXXX XXX XXX XX XXX  XXX XX XX
XXXXX XXXX XX XXXXXXXXXXX XXX XXXX XX XXX XXXX XXX XX XXXXXXXXXXXXXXX XXXX XXX XXX XX XXX XXXX XX XX
X                             XXXX XX XXX XXXX                             XXX XXX XX XXX         XX
XX XXXXXXX XXX XXXXXX XXXXXXc      XX XXX XXXX XXX XX XXXXXXXXXXXXXXXXXXXX         XX XXX XXXX XX XX
XX XXXXXXX XXX XXXXXX XXXXXXX XXXX XX XXX XXXX XXX XX XXXXXXXXXXXXXXXXXXXX XXX XXX XX XXX XXXX XX XX
XX XXXXXXX XXX XXXXXX XXXXXXX XXXX XX XXX XXXX XXX XX XXXXXXXXXXXXXXXXXXXX XXX XX  XX XXX XXXX XX XX
XX XXXXXXX             XXXXXX XXXX XX XXX XXXX XXX X   XXXXXXXXXXXXXXXXXXX XXX X   XX XXX XXXX XX XX
XX          XX XXXXXX         XXXX XX XXX XXXX                                     XX XXX XXXX XX XX
XX XXXXXXX XXX XXXXXX  XXXXXX XXXX XX XXX XXXX XX XXX XXXXXXXXXXXXXXXXXXXX XX XXXX XX XXX XXXX XX XX
XX XXXXXXX XXX XXXXXX XXXXXXX XXXX XX XXX XXXX XX XXX XXXXXXXXXXXXXXXXXXXX XX XXXX XX  XX XXXX XX XX
XX XXXXXXX XXX XXXXXX XXXXXXX XXXX XX XXX XXXX XX XXX XXXXXXXXXXXXXXXXXXXX XX XXXX XX     XXXX XX  X
XX XXXXXXX XXX XXXXXX XXXXXXX         XXX XXXX XX XXX XXXXXXXXXXXXXXXXXXXX XX XXXX XX  XX XXXX XX  X
XX XXXXXXX XXX XXXXXX XXXXXXX XXXX XX XXX XXXX XX XXX XXXXXXXXXXXXXXXXXXXX XX XXXX XX XXX XXXX XX  X
XX XXXXXXX XXX XXXXXX XXXXXXX XXXX XX XXX XXXX XX XXX XXXXXXXXXXXXXXXXXXXX XX XXXX XX XXX XXXX XX XX
XX XXXXXXX XXX XXXXXX XXXXXXX XXXX XX XXX XXXX XX                                  XX XXX XXXX XX XX
X  f       XXX XXXXXX XXXXXXX XXXX XX XXX XXXX XX XXX XXXXXXXXXXXXXXXXXXXX XX XXXX                 X
XX XXXXXXX XXX XXXXXX XXXXXXX XXXX XX XXX XXXX XX XXX XXXXXXXXXXXXXXXXXXXX XX XXXX XX XXX XXXXXXX XX
XX XXXXXXX XXX XXXXXX XXXXXXX XXXX XX XXX XXXX XXHXXX XXXXXXXXXXXXXXXXXXXX XX XXXX XX XXX XXXXXXX XX
XX XXXXXXX XXX                XXXX XX XXX XXXX XX XXX XXXXXXXXXXXXXXXXXXXX XX XXXXdXX XXXgXXXXXXX XX
X          XXX XXX XX XXXXXXX XXXX XX                                   F  XX XXXX XX XXX XXXXXXX XX
XX XXXXXXX XXX XXX XX XXXXXXX XXXX XX XXX XXXX XX XXXXXXXXXXXXXXXXXXXXXXXX XX XXXX XX XXX XXXXXXX XX
XX XXXXXXX XXX XXX XX XXXXXXX XXXX XX XXX XXXX XX XXXXXXXXXXXXXXXXXXXXXXXX XX XXXX XX XXX XXXXXXX XX
XX XXXXXXX XXX XXX XX              XX                                 b            XX XXX XXXXXXX XX
XX XXXXXXX XXX XXX XX XXX XXX XXXX XX XXXXXXXX XXXXXXXXXXXXXX XXXXXXXXXXXX XXXXXXX XX XXX XXXXXXX XX
XX XXXXXXX XXX XXX XX XXX XXX XXXX XX XXXXXXXX XXXXXXXXXXXXXX XXXXXXXXXXXX XXXXXXX XX XXX XXXXXXX XX
XX XXXXXXX XXX XXX XX XXX XXX XXXX XX XXXXXXXX XXXXXXXXXXXXXX XXXXXXXXXXXX XXXXXXX XX XXX XXXXXXX XX
XX XXXXXXX XXX XXX XX XXX XXX XXXX XX XXXXXXXX XXXXXXXXXXXXXX XXXXXXXXXXXX XXXXXXX XX XXX XXXXXXX XX
XX XXXXXXX XXX        XXX XXX XXXX XX XXXXXXXX XXXXXXXXXXXXXX                                      X
XX XXXXXXX XXX XXX XX XXX XXX XXXX XX XXXXXXXX XXXXXXXXXXXXXX XXX XXXXXXXX XXXXXXX XXXXXX XXXXXXXXXX
XX XXXXXXX XXX XXX XX XXX XXX XXXX XX XXXXXXXX XXXXXXXXXXXXXX XXX XXXXXXXX XXXXXXX XXXXXX XXXXXXXXXX
XX XXXXXXX XXX XXX XX XXX XXX XXX  XX XXXXXXXX XXXXXXXXXXXXXX XXX XXXXXXXX XXXXXXX XXXXXX XXXXXXXXXX
XX XXXXXXX XXX XXX XX XXX XXX      XX XXXXXXXX XXXXXXXXXXXXXXhXXX XXXXXXXX XXXXXXX XXXXXX XXXXXXXXXX
XX XXXXXXX XXX XXX XX XXX XXX XXX  XX XXXXXXXX XXXXXXXXXXXXXX XXX XXXXXXXX XXXXXXX XXXXXX XXXXXXXXXX
XX XXXXXXX XXX XXX XX XXX XXX XXXX XX XXXXXXXX XXXXXXXXXXXXXX XXX XXXXXXXX XXXXXXX XXXXXX XXXXXXXXXX
XX XXXXXXX XXX XXX XX          XXX XX  XXXXXXX XXXXXXXXXXXXXX XX   XXXXXXX XXXXXXX XXXXXX XXXXXXXXXX
XX XXXXXXXBXXX XXX XX XXX XXX                         C                                            X
XX XXXXXXX XXX XXX XX XXX XXX XXXXXXXX XXXXXXXXXXXXXXXXXXXXXX XXXXXXX XXXXXXX XXXX XXX XXX XXXXXXXXX
XX XXXXXXX XXX XXX XX XXX XXX XXXXXXXX XXXXXXXXXXXXXXXXXXXXXX XXXXXXX XXXXXXX XXXX XXX XXX XXXXXXXXX
XX XXXXXXX XX  XXX XX         XXXXXXXX XXXXXXXXXXXXXXXXXXXXXX XXXXXXX XXXXXXX XXXX XXX XXX XXXXXXXXX
XX XXXXXXX     XXX XX   X XXX                                                      XXX XXX XXXXXXXXX
XX XXXXXXX XX  XXX XX  XX XXX XXXXXXXXXXX XXXX XXXXXX XXX XXXXXXXXXXX XXXXXXX XXXX XXX XXX XXXXXXXXX
XX XXXXXXX XXX XXX XX XXX XXX XXXXXXXXXXX XXXX XXXXXX XXX XXXXXXXXXXX XXXXXXX XXXX XXX XXX XXXXXXXXX
XX XXXXXXX                    XXXXXXXXXXX  XXX XXXXXX                 XXXXXXX XXXX         XXXXXXXXX
XX XXXXXXX XX XXXXXXX XXXXXXX XXXXXXXXXXX      XXXXXX XXXAXXXXXXXXXXX XXXXXXX XXXX XXX XXX XXXXXXXXX
XX XXXXXXX XX XXXXXXX XXXXXXX XXXXXXXXXXX  XXX XXXXXX XXX XXXXXXXXXXX XXXXXXX XXXX XXX XXX XXXXXXXXX
XX XXXXXXX XX XXXXXXX XXXXXXX XXXXXXXXXXX XXXX XXXXXX  XX  XXXXXXXXXX XXXXXXX XXXX XXX XXX XXXXXXXXX
XX XXXXXXX XX XXXXXXX                                                 XXXXXXX XXXX XXX XXX XXXXXXXXX
XX XXXXXXX            XXXX XX XXXXXXXXXXX XXXX X   XX  XX  XXXXXXXXXX XXXXXXX XXXX XXX             X
XX XXXXXXX XX XXXXXXX XXXX XX XXXXXXXXXXX XXXX XX XXX XXX XXXXXXXXXXX XXXXXXX XXXX XXX XXX XXXXXXXXX
XX XXXXXXX XX XXXXXXX XXXX XX XXXXXXXXXXX XXXX XX XXX XXX  XXXXXXXXXX XXXXXXX XXXX XXX XXX XXXXXXXXX
XX XXXXXXX XX XXXXXXX XXXX XX XXXXXXXXXXX XXXX XX XXX XXX             XXXXXXX XXXX XXX XXX XXXXXXXXX
X          XX XXXXXXX XXXX XX XXXXXXXXXXX XXXX XX XXX XXX  XXXXXXXXXX XXXXXXX XXXX XXX XXX XXXXXXXXX
XX XXXXXXX XX XXXXXXX XXXX XX XXXXXXXXXXX XXXX XX XXX XXX XXXXXXXXXXX XXXXXXX XXXX XXX XXX XXXXXXXXX
XX XXXXXXX XX XXXXXXX XXXX XX XXXXXXXXXXX XXXX XX XXX XXX XXXXXXXXXXX XXXXXXX XXXX XXX XXX XXXXXXXXX
XX XXXXXXX XX XXXXXXX XXXX XX XXXXXXXXXXX                             XXXXXXX XXXX                 X
XX XXXXXXX XX XXXXXXX XXXX XX XXXXXXXXXXX XXXXXXXXXXX XXXXXXX   XXXXX XXXXXXX XXXX XXX XXXXXXXXXXXXX
XX XXXXXXX XX XXXXXXX XXXX XX XXXXXXXXXXX XXXXXXXXXXX XXXXXXXX XXXXXX XXXXXXX XXXX XXX XXXXXXXXXXXXX
XX XXXXXXX XXaXXXXXXX XXXX XX  XXXXXXXXXX XXXXXXXXXXX XXXXXXXX XXXXXX XXXXXXX XXXX XXX XXXXXXXXXXXXX
XX XXXXXXX XX XXXXXXX XXXX XX             XXXXXXXXXXX XXXXXXXX XXXXXX XXXXXXX XXXX                DX
XX XXXXXXX XX XXXXXXX XXXX XX  XXXXXXXXXX XXXXXXXXXXX XXXXXXXX XXXXXX XXXXXXX XXXX XXX XX XXXX XXXXX
XX XXXXXXX XX XXXXXXX XXXX XX XXXXXXXXXXX XXXXXXXXXXX XXXXXXXX XXXXXX XXXXXXX XXXX XXX XX XXXX XXXXX
XX XXXXXXX XX XXXXXXX XXXX XX XXXXXXXXXXX XXXXXXXXXXX XXXXXXXX XXXXXX XXXXXXX XXXX XXX XX XXXX XXXXX
XX XXXXXXX XX XXXXXXX XXXX XX XXXXXXXXXXX XXXXXXXXXXX XXXXXXXX XXXXXX XXXXXXX XXXX XXX XX XXXX XXXXX
XX XXXXXXX XX XXXXXXX         XXXXXXXXXXX XXXXXXXXXXX XXXXXXXX XXXXXX XXXXXXX XXXX XXX             X
XX XXXXXXX XX XXXXXXX XXXX XX XXXXXXXXXXX XXXXXXXXXXX XXXXXXXX XXXXXX XXXXXXX XXXX XXX XX XXXX XXXXX
XX XXXXXXX XX XXXXXXX XXXX XX  XXXXXXXXXX XXXXXXXXXXX XXXXXXXX XXXXXX XXXXXXX XXXX XXX XX XXXX XXXXX
XX XXXXXXX XX XXXXXXX XXXX XX   XXXXXXXXX XXXXXXXXXXX XXXXXXXX XXXXXX  XXXXXX XXXX XXX XX XXXX XXXXX
XX XXXXXXX XX XXXXXXX XXXX XX                                                          XX XXXX XXXXX
XX XXXXXXX XX XXXXXXX XXXX XX XXXXXXXXXXX XXXXXXXXXXXXXXXXXXXXXXXXXXX  XXXXXXXXXXX XXX XX XXXX XXXXX
XX XXXXXXX XX XXXXXXX  XXX XX XXXXXXXXXXX XXXXXXXXXXXXXXXXXXXXXXXXXXX XXXXXXXXXXXX XXX XX XXXX XXXXX
XX XXXXXXX XX XXXXXXX      XX XXXXXXXXXXX XXXXXXXXXXXXXXXXXXXXXXXXXXX XXXXXXXXXXXX XXX XX XXXX XXXXX
XX XXXXXXX XX XXXXXXXE XXX XX XXXXXXXXXXX XXXXXXXXXXXXXXXXXXXXXXXXXXX XXXXXXXXXXXX XXX XX XXXX XXXXX
XX XXXXXXX XX XXXXXXX XXXX XX XXXXXXXXXXX XXXXXXXXXXXXXXXXXXXXXXXXXXX XXXXXXXXXXXX XXX XX XXXX XXXXX
XX XXXXXXX XX XXXXXXX XXXX XX XXXXXXXXXXX XXXXXXXXXXXXXXXXXXXXXXXXXXX XXXXXXXXXXXX XXX XX XXXX XXXXX
X  XXXXXXX XX XXXXXXX XXXX XX XXXXXXXXXXXTXXXXXXXXXXXXXXXXXXXXXXXXXXX                  XX XXXX XXXXX
X  XXXXXXX                    XXXXXXXXXXX XXXXXXXXXXXXXXXXXXXXXXXXXXX XXXXXXXXXXXX XXX XX XXXX XXXXX
XXXXXXXXXXXXXXXXXXXXXXXXXXXXXXXXXXXXXXXXXXXXXXXXXXXXXXXXXXXXXXXXXXXXXXXXXXXXXXXXXXXXXXXXXXXXXXXXXXXX