XXXXXXXXXXXXXXXXXXXXXXXXXXXXXXXXXXXXXXXXXXXXXXXXXXXXXXXXXXXXXXXXXXXXXXXXXXXXXXXXXXXXXXXXXXXXXXXXXXXX
XAXXX  bXXXX   X    XX XX   XX XXXXXXXXXXX XXXXXX XXX XXXX XXXXXXX                 XX XXX XXXXXXX BX
X                                                 XXX XXXX XXXXXXX XX XX   XX XXX                  X
X XXX XXXX XXX XXXXXXX XXXXXXX XX XXX XXXX XX XXX XXX XXXX XXXXXXX XX XXX XXX XXX  XX XXX XXXXXXX XX
X XXX XXXX XXX XXXXXXX XXXXXXX XX XXX XXXX XX XXX XXX XXXX XXXXXXX XX XXX XXX XXX XXX XXX XXXXXXX XX
X XXX XXXX XX   XXXXXX XXXXXXX XX XXX XXXX XX XXX XXX XXXX XXXXXXX XX XXX XXX XXX XXX XXX XXXXXXX XX
X XXX                                 XXXX XX XXX XXX              XX XXX                          X
X XXX XXXX XXXXXXXXXXXXXXXXXXX XX XXX XXXX XX XXX XXX XXXX XX XXXX XX XXX XXX XXX XXXX XXX XXXXXX XX
X XXX XXX  XXXXXXXXXXXXXXXXXXX XX XXX XXXX XX XXX XXX XXXX XX XXXX XX XXX XXX XXX XXXX XXX XXXXXX XX
X XXX                                      XX XXX XXX XXXX XX XXXX XX XX      XXX XXXX XXX XXXXXX  X
X XXX XXX  XXXXXXXXXXXXXXXXXXX XX XXX XXXX        XXX XXXX XX XXXX        XXX XXX                  X
X XXX XXXX XXXXXXXXXXXXXXXXXXX XX XXX XXXX XX XXX XXX XXXX XX XXXX XX XXX XXX XXX XXXX XXX XXXXXX  X
X XXX XXXX XXXXXXXXXXXXXXXXXXX XX  XX  XXX XX XXX XXX XXXX XX XXX  XX XXX XXX XXX XXX  XXX XXXXXX XX
X                              XX   X   XX XX XXX XXX XXXX XX      XX XXX XXX XXX                  X
X XXX XXXX XXXXX   XX   XXXX               XX XXX XXX XXXX XX XXX  XX XXX XXX XXX XXX  XXXXXXXXXX XX
X XXX XXXX XXXXXX XXXX XXXXXX  XX XXX XXXX XX XXX XXX XXXX XX XXXX XX XXX XXX XXX XXXX XXXXXXXXXX XX
X XXX XXXX XXXXXX XXX  XXXXXXX XX XXX XXXX XX XXX XXX XXXX XX XXXX XX XXX XXX XXX XXXX XXXXXXXXXX  X
X XX   XXX XXXXXX XX   XXXXXXX XX XX       XX XXX                                                  X
X                                     XXXX        XXX  XXXXXX XXXX XX XXXXXXX   X XXXXXXXXXXX XXX  X
X XXX XXXX XXXXXX XXXX XXXXXXX XX XXX XXXX XX XXX XXXX XXXXXX XXXX XX XXXXXXX  XX XXXXXXXXXXX XXXX X
X XXX XXXX XXXXXX XXXX XXXXXX  XX XXX XXXX XX XXX XXXX XXXXXX XXXX XX XXXXXXX XXX XXXXXXXXXXX XXXX X
X  XX XXXX XXXXXX              XX XXX  XXX XX XXX XXXX XXXXXX XXXX XX XXXXXXX  XX XXXXXXXXXXX XXXX X
X     XXXX XXXXXX XXXXXXXX XX  XX XXX             XXXX             XX XXXXXXX                      X
X XXX XXXX XXXXXX XXXXXXXX XXX XX XXX  XXX XXXXXX XXXX XXXXXX XXXX XX XXXXXXX  XX XXX XXX XXX XXXXXX
X XXX XXXX XXXXXX XXXXXXXX XXX XX  XX XXXX XXXXXX XXXX XXXXXX XXXX XX XXXXXXX XXX XXX XXX XXX XXXXXX
X XXX XXXX XXXXX   XXXXXXX XXX XX   X XXXX XXXXX   XXX XXXXXX XXXX XX XXXXXXX XXX  X   XX XXX XXXXXX
X                                                                                                  X
X XXXXXXXXXXXXXXX XXXX XX  XXX XX XXXXXXXXXXXXXXX XXXX XXXXXXX XX XXXXXXXX XX XXXX XXXXXX XXXXXXXX X
X XXXXXXXXXXXXXXX XXXX XX XXXX XX XXXXXXXXXXXXXXX XXXX XXXXXXX XX XXXXXXXX XX  XXX XXXXXX XXXXXXXX X
X XXXXXXXXXXXXXXX XXXX XX XXX   X XXXXXXXXXXXXXXX XXX   XXXXXX XX  XXXXXX   X   XX XXXXX   XXXXXXX X
X                                                                                                  X
X XXXXXXXXXXXXXXXXXXXX XX XXXX XX XXXXXXX XXXXXXX XXXXXXXXXXX  XX  XXXXXXXXXXXXXXXXXXXXXXX XX XXXX X
X XXXXXXXXXXXXXXXXXXXX XX XXXX XX XXXXXXX XXXXXXX XXXXXXXXXXX XXX XXXXXXXXXXXXXXXXXXXXXXXX XX XXXX X
X  XXXXXXXXXXXXXXXXXXX XX XXXX                                                             XX XXXX X
X                              XX XXX XXX XXX XXXXXXXXXXX   X XXXXXXXXXXX XXXXXXXXXXXXXXX     XXXX X
X  XXX XXXXXXXXXXXXXXX XX XXXX XX XXX XXX XXX XXXXXXXXXXXX XX XXXXXXXXXXX XXXXXXXXXXXXXXXX XX XXXX X
X XXXX XXXXXXXXXXXXXXX XX XXXX XX XXX XXX XXX XXXXXXXXXXXX XX XXXXXXXXXXX XXXXXXXXXXXXXXXX XX XXXX X
X XXXX XXXXXXXXXXXXXX  XX  XXX XX XX   XX XXX XXXXXXXXXXXX XX XXXXXXXXXX   XXXXXXXXXXXXXXX XX XXXX X
X XXXX                 XX      XX                                                                  X
X XXXX XXXXXXXXXXX XX  XX  XXX XX XXXXXXXX XX XXXXXXX XXXXXXXX XXXXXXXXXXXXXXXXXXXXXXXXXXX XX XXXX X
X XXXX XXXXXXXXXXX XXX XX XXXX XX XXXXXXXX XX XXXXXXX XXXXXXX  XXXXXXXXXXXXXXXXXXXXXXXXXXX XX XXXX X
X                          XXX XX                                                          XX XXXX X
X   X  XX XXX   XX XXX XX         XXXXXXXX X   X   X   XXXXXX  XXXXXXX XXX XXXXXXXXXXX XX          X
X  XX XXX XXXX XXX XXX XX XXXX XX XXXXXXXX XX XXX  XX XXXXXXXX XXXXXXX XXX XXXXXXXXXXX XXX XXXXXXX X
X XXX XXX XXXX XXX XXX XX XXXX XX XXXXXXXX XX XXXX XX XXXXXXXX XXXXXXX XXX XXXXXXXXXXX XX  XXXXXXX X
X         XXXX XXX XXX         XX                                                          XXXXXXX X
X XXX          XXX XXX XX XX   XX XXX   XXXXX   XX XXXXXXXXXXX XXX X   XXX XXXXXX XXXX XX          X
X XXX  XX XXXX XXX XXX XX XXX  XX XXX  XXXXXXX XXX XXXXXXXXXXX XXX XX  XXX XXXXXX XXXX XXX XXXXXXX X
X XXX XXX XXX  XXX XXX XX XXXX XX XXX  XXXXXXX XXX XXXXXXXXXXX XXX XXX XXX XXXXXX XXXX XXX XXXXXXX X
X XXX XXX      XXX XXX XX XXXX XX XXX          XX   XXXXXXXXXX XXX XXX XXX XXXXXX XXXX XXX XXXXXXX X
X XXX XXX XXX  XXX XXX XX XXXX XX XXX  XXXXXXX                 XXX XXX XXX             XXX XXXXXXX X
X XXX XXX XXXX XXX XXX XX XXXX XX XXX XXXXXXXX XXX XXX XXXXXXX XXX XXX XXX XXXXXX XXXX XXX XXXXXXX X
X XXX XXX XXXX XXX XXX XX XXXX XX XXX XXXXXXXX XXX XXX XXXXXXX XXX XX  XXX XXXXXX XXXX XXX XXXXXXX X
X XXX XX   XXX XXX XX  XX XXXX XX XXX XXXXXXX   X  XXX XXXXXXX XX      XXX XXXXXX XXXX XXX XXXXXXX X
X                                                                                                  X
X XXXX XX XXXX XX XXX  XX XXXX XX XXX XXX XXXX XX  XXX XX XXXX XXXXXXXXXXXXXXXXXX  XXX XX XXX XXX XX
X  XXX XX XXXX XX XXXX XX XXXX XX XXX  XX XXXX XXX XXX XX XXXX XXXXXXXXXXXXXXXXXXX XXX XX XXX XXX XX
X      XX XXXX XX  XXX XX XXX   X XXX      XXX XXX XXX XX XXXX XXXXXXXXXXXXXXXXXXX XXX XX XXX XXX XX
X  XXX XX XXXX XX      XX                                      XXXXXXXXXXXXXXXXXXX XXX             X
X XXXX XX XXXX XX  XXX XX XXXXXXXXXXXXXXXX XXX XXX XX XXX XXXX XXXXXXXXXXXXXXXXXXX XXX XX XXX XXX XX
X  XXX XX XXXX XX XXX  XX  XXXXXXXXXXXXXXX XXX XXX XX XXX XXXX XXXXXXXXXXXXXXXXXXX XXX XX XXX XXX XX
X      XX XXXX XX                                  XX XXX XXXX XXXXXXXXXXXXXXXXXXX XX  XX XXX  XX XX
X  XXX XX XXXX XX XXX  XX  XXXXX   XXXXX   XX XXXX                                                XX
X XXXX XX XXXX XX XXXX XX XXXXXXX XXXXXXX XXX XXXX XX XXXXXXXX XXXXXXXXXXXXXXX XXX XX  XX XXX  XX XX
X XXXX XX XXXX XX XXXX XX XXXXXXX XXXXXXX XXX XXXX XX XXXXXXXX XXXXXXXXXXXXXXX XX  XXX XX XXX XXX XX
X  XXX XX XXXX XX XXX             XXXXXXX XXX XXXX XX XXXXXXXX XXXXXXXXXXXXXXX X   XX      XX  XX  X
X                      XX XXXXXXX XXXXXXX XXX XXXX                                                 X
X XXXX XXX XXX XX XXX  XX XXXXXXX XXXXXXX XXX XXXX XXXXXX XXXX XX XXX XXXX XXX XXX XXX XXXXXX  XX  X
X XXXX XXX XXX XX XXXX XX XXXXXXX XXXXXXX XXX XXXX XXXXXX XXXX XX XXX XXX  XXX XXX XXX XXXXXX XXX XX
X  XXX XX   XX XX  XXX XX XXXXXXX             XXXX XXXXXX  XX      XX XX   XX  XXX XXX XXXXXX XXX XX
X                      XX XXXXXXX XXXXXXX XXX XXXX XXXXXX                                     XXX XX
X XXXX XXXXXXXXXX  XXX XX XXXXXXX XXXXXXX XXX XXXX XXXXXX  XXX XXXXXX XXXX XX  XXX XXX XXXXXX XXX XX
X XXXX XXXXXXXXXX XXXX XX  XXXXXX XXXXXXX XXX XXXX XXXXXX XXXX XXXXXX XXXX XXX XXX XXX XXXXXX XXX XX
X XXXX XXXXXXXXXX XXXX XX   XXXXX XXXXXX   XX XXXX XXXXXX XXXX XXXXXX XXXX XXX XXX XXX XXXXXX XXX XX
X                                                                                             XXX XX
X XXXXXXXX XXXXXX XXXX XX XXX XXXXXXXX XXXXXX XXXX XX XXX XXXXXXXXXXXX XXX XXXXXX XXX XXXXXXX XXX XX
X XXXXXXXX XXXXXX XXXX XX XXX XXXXXXXX XXXXXX XXXX XX XXX  XXXXXXXXXXX XXX XXXXXX XXX XXXXXXX XXX XX
X XXXXXXXX XXXXX   XXX XX  XX                 XXXX XX XXX   XXXXXXXXXX XXX XXXXXX             XXX XX
X                      XX     XXXXXX   XXXXXX XXXX XX XXX                  XXXXXX   X XXXXXXX      X
X XXXXXXXX XXX XXXXXXX XX  XX XXXXXXX  XXXXXX XXXX XX XXX XXXXXXXXXXXX XXX XXXXXX  XX XXXXXXX XXX XX
X XXXXXXX  XXX XXXXXXX XX XXX XXXXXXXX XXXXXX XXXX XX XXX  XXXXXXXXXXX XXX XXXXXX XXX XXXXXXX XXX XX
X          XXX XXXXXXX XX XXX XXXXXXXX XXXXXX XXXX XX XXX                                     XXX XX
X XXXXXXX              XX                     XXXX         XXXXXXXXXXXXXXX XXXXXX XXXXXXXXXXX XXX XX
X XXXXXXXX XXX XXXXXXX XX XXX XXXX XXXXXXXXXX XXXX XX XXX XXXXXXXXXXXXXXXX XXXXXX XXXXXXXXXXX XXX XX
X  XXXXXXX XXX XXXXXXX XX  XX XXXX XXXXXXXXXX XXXX XX XXX XXXXXXXXXXXXXXX  XXXXXX XXXXXXXXXXX  XX XX
X                      XX   X XXXX XXXXXXXXX   XXX X   XX XXXXXXXXXXXXXX   XXXXXX XXXXXXXXXXX   X  X
X      XXX X   XXXXXXX XX                                                                          X
X  XX  XXX XX XXXXXXXX XX XXXXXXXX XXX XXXXXX XXXX XXX XX XXXXXXX XXXXXXXXXXXXXXXXXXXXXXXX XXXXXX  X
X  XXX XXX XX XXXXXXXX XX XXXXXXXX XXX XXXXXX XXXX XXX XX XXXXXXX XXXXXXXXXXXXXXXXXXXXXXXX XXXXXX XX
X   X   XX XX XXXXXXXX XX XXXXXXXX XX   XXXXX XXXX XXX XX XXXXXX   XXXXXXXXXXXXXXXXXXXXXX   XXXXX  X
X                                                                                                  X
X XXXXXXXXXXXXXXX XXXX XX XXXXXXXXXXXX XXXXXX XXXX XXX XX XXXX XX XXXXXXXXXXXXXXXX XX XXX XXXX XX  X
X XXXXXXXXXXXXXXX XXXX XX XXXXXXXXXXXX XXXXXX XXXX XXX XX XXXX XX XXXXXXXXXXXXXXXX XX XXX XXXX XX XX
X                      XX                          XXX XX XXX  XX XXXXXXXXXXXXXXXX        XXXX XX XX
X XXXXXX   XXXXXX XXXX XX   XXXXXX XXX XXXXXXXXXXX XXX XX                          XX XXX XXXX XX XX
X XXXXXXX XXXXXXX XXXX XX  XXXXXXX XXX XXXXXXXXXXX XXX XX XXX  XX XXXXXXXXXXXXXXXX XX XXX XXXX XX XX
X XXXXXXX XXXXXXX XXXX XX XXXXXXXX XXX XXXXXXXXXXX XXX XX XXX  XX  XXXXXXXXXXXXXX  XX XXX XXXX XX XX
X XXXXXXX XXXXXXX XXXX XX              XXXXXXXXXXX XXX XX XX   XX   XXXXXXXXXXXX    X XXX XXX      X
XaXXXXXXX XXXXXXX XXXX XX XXX   XX XXX XXXXXXXXXXX                                                 X
XXXXXXXXXXXXXXXXXXXXXXXXXXXXXXXXXXXXXXXXXXXXXXXXXXXXXXXXXXXXXXXXXXXXXXXXXXXXXXXXXXXXXXXXXXXXXXXXXXXX
