XXXXXXXXXXXXXXXXXXXXXXXXXXXXXXXXXXXXXXXXXXXXXXXXXXXXXXXXXXXXXXXXXXXXXXXXXXXXXXXXXXXXXXXXXXXXXXXXXXXX
X                                             A                                                    X
X XXXXXXXXXXXXXXXXXXXXXXXXXXXXXXXXXXXX XXXXXXXXXXXXXXXXXXXXXXXXXXX XXXXXXXXXX XXXXXXXXXXXX XX XXXXXX
X XXXXXXXXXXXXXXXXXXXXXXXXXXXXXXXXXXXX XXXXXXXXXXXXXXXXXXXXXXXXXXX XXXXXXXXXX XXXXXXXXXXXX XX XXXXXX
X XXXXXXXXXXXXXXXXXXXXXXXXXXXXXXXXXXXX XXXXXXXXXXXXXXXXXXXXXXXXXXX XXXXXXXXXX XXXXXXXXXXXX XX XXXXXX
X XXXXXXXXXXXXXXXXXXXXXXXXXXXXXXXXXXXX XXXXXXXXXXXXXXXXXXXXXXXXXXX                         XX XXXXXX
X                                      XXXXXXXXXXXXXXXXXXXXXXXXXXX XXXXXXXXXX XXXXXXXXXXXX XX XXXXXX
X XXXXXXXXXXXXXXXXXXXXXXXXXXXXXXXXXXXX XXXXXXXXXXXXXXXXXXXXXXXXXXX XXXXXXXXXX XXXXXXXXXXXXdXX XXXXXX
X XXXXXXXXXXXXXXXXXXXXXXXXXXXXXXXXXXXX XXXXXXXXXXXXXXXXXXXXXXXXXXX XXXXXXXXXX XXXXXXXXXXXX XX XXXXXX
X                                                                                                  X
XXXXXXXXXX XXXXXXX XXX XXX XXXXXXX XXX XXX XXXXXXX XX XXXXXXXXXXX XXXX XX XXX XXX XXXXXXXX XX XXX XX
XXXXXXXXXX XXXXXXX XXX XXX XXXXXXX XXX XXX XXXXXXX XX XXXXXXXXXXX XXXX XX XXX XXX XXXXXXXX XX XXX XX
XXXXXXXXXX XXXXXXX XXX XXX XXXXXXX XXX XXX XXXXXXX XX XXXXXXXXXXX XXXX XX XXX XXX XXXXXXXX XX XXX XX
XXXXXXXXXX XXXXXXX XXX XXX XXXXXXX XXX XXX XXXXXXX XX XXXXXXXXXXX XXXX XX XXX              XX      X
XXXXXXXXXX XXXXXXX XXX XXX XXXXXXX XXX XXX                                XXX XXX XXXXXXXX XX XXX XX
XXXXXXXXXX XXXXXXX XXX XXX XXXXXXX XXX XXX XX XXXX XX XXXXXXXXXXX XXXX XX XXX XXXcXXXXXXXX XX XXX XX
XXXXXXXXXX XXXXXXX XXX XXX XXXXXXX XXX XXX XX XXXX XX  XXXXXXXXXX XXXX XX XXX  XX XXXXXXXX XX XXX XX
X                          XXXXXXX XXX      X XXXX XX             XXXX XX XXX              XX XXX XX
XXXXXXXXXX XXXXX   XXX XXX XXXXXXXbXXX XXX             XXX XXXXXX XXXX XX XXX  XXX XXXXXXX XX XXX XX
XXXXXXXXXX XXXXXX  XXX XXX XXXXXXX XXX XXX XX XXXXXXX XXXX XXXXXX XXXX XX XXX XXXX XXXXXXX XX XXX XX
XXXXXXXXXX XXXXXXX XXX XXX XXXXXXX XXX XXX XX XXXXXXX XXXX XXXXXX XXXX XX XXX XXXX XXXXXXX XX XXX XX
XXXXXXXXXX XXXXXX  XXX XXX XXXXXXX XXX XXX XX XXXXXXX XXX   XXXXX       X XXX XXXX XXXXXXX XX XXX XX
X                  XXX XXX                                        XXXX        XXXX XXXXXXX XX XXX XX
XXXXXXXXXX XXXXXX  XXX XXX XXXXXXX XXX XXX XXXXXXXXXX XXXXXXXXXXX XXXX XX XXX XXXX XXXXXXX XX XXX XX
XXXXXXXXXX XXXXXXX XXX XXX XXXXXXX XXX XXX XXXXXXXXXX XXXXXXXXXXX XXXX XX XXX XXXX XXXXXXX XX XXX XX
XXXXXXXXXX             XXX XXXXXXX XXX XXX XXXXXXXXXX  XXXXXXXXXX XXXXDXX XXX XXXX XXXXXXX         X
XXXXXXXXXX XXXXXXX XXX XXX XXXXXXX XXX XXX XXXXXXXXXX             XXXX XX XXX              XX XXXXXX
XXXXXXXXXX XXXXXXX XXX XXX XXXXXXX XXX XXX XXXXXXXXXX  XX XXXXXXX XXXX XX XXX XXXX XXX XXX XX XXXXXX
XXXXXXXXXX XXXXXXX XX  XXX XXXXXXX XXX XXX XXXXXXXXXX XXX  XXXXXX XXXX XX XXX XXXX XXX XXX XX XXXXXX
XXXXXXXXXX XXXXXXX     XXX XXXXXXX XXX XXX XXXXXXXXXX XXX          XXX XX XXX XXXX         XX XXXXXX
XXXXXXXXXX XXXXXXX XX  XXX XXXXXXX XXX XXX XXXXXXXXXX XXX  XXX XX      XX XXX XXXX XXX XXX XX XXXXXX
XXXXXXXXXX XXXXXXX XXX XXX XXXXXXX XXX XXX XXXXXXXXXX XXX XXXX XX  XXX XXEXXX XXXX XXX XXX XX XXXXXX
XXXXXXXXXX XXXXXXX XXX XXX XXXXXXX XXX XXX XXXXXXXXXX XXX XXXX XX XXXX XX XXX XXXX XXX XXX XX XXXXXX
X                          XXXXXXX XXX XXX XXXXXXXXXX XXX XXXX XX XXXX        XXXX XXX XX  XX XXXXXX
XXXXXXXXXX XXXXXXX XXX XXX XXXXXXX XXX XXX                        XXXX XX XXX              XX XXXXXX
XXXXXXXXXX XXXXXXX XXX XXX XXXXXXX XXX XXX XXXXXXX XX XXX XXXX XX XXXX XX XXX XXXX XXXXXX  XX XXXXXX
XXXXXXXXXX XXXXXXX XXX XXX XXXXXXX XXX XXX XXXXXXX XX XXX XXXX XX  XXX XX XXX XXXX XXXXXXX XX XXXXXX
XXXXXXXXXX XXXXXXX XXX XXX XXXXXXX XXX XXX XXXXXXX XX XXX XXXX XX      XX XXX XXXX XXXXXXX XX  XXXXX
XXXXXXXXXX XXXXXXX XXX XXX XXXXXXX XXX XXX XXXXXXX XX XXX XXXX XX  XXX XX XXX XXXX XXXXXXX XX      X
XXXXXXXXXX XXXXXXX XXX XXX XXXXXXX XXX XXX XXXXXXX XX XXX XXXX XX XXXX XX XXX XXXX XXXXXXX XX  XXXXX
XXXXXXXXXX XXXXXXX XXX XXX XXXXXXX XXX XXX XXXXXXX XX XXX XXXX XX XXXX XX XXX XXXX XXXXXXX XX XXXXXX
XXXXXXXXXX XXXXXXX XXX XXX XXXXXXX XXX XXX XXXXXXX XX XXX XXXX XX  XXX XX XXX XXXX XXXXXXX XX XXXXXX
XXXXXXXXXX XXXXXXX XXX XXX XXXXXXX XXX XXX XXXXXXX XX                  XX XXX XXXX XXXXXXX XX XXXXXX
XXXXXXXXXX XXXXXXX XXX XXX XXXXXXX XXX XXX XXXXXXX XX XXX XXXXXXX  XXX XX XXX XXXX XXXXXXX XX XXXXXX
XXXXXXXXXX XXXXXXX XXX XXX XXXXXXX XXX XXX XXXXXXX XX XXX XXXXXXX XXXX XX XXX XXXX XXXXXXX XX XXXXXX
XXXXXXXXXX XXXXXXX XX                  XXX XXXXXXX XX XXX XXXXXXX XXXX XX XXX XXXX XXXXXXX XX XXXXXX
XXXXXXXXXX XXXXXXX     XXX XXXXXXXXXXX XXX XXXXXXX XX XXX XXXXXXX XXXX XX XXX              XX XXXXXX
XXXXXXXXXX XXXXXXX XX  XXX XXXXXXXXXXX XXX XXXXXXX XX XXX XXXXXXX XXXX XX XXX XXXX XXXXXXX XX XXXXXX
XXXXXXXXXX XXXXXXX XXX XXX XXXXXXXXXXX XXX XXXXXXX XX XXX XXXXXXX XXXX XX XXX XXXX XXXXXXX XX XXXXXX
XXXXXXXXXX             XXX XXXXXXXXXXX XXX XXXXXXX XX XXX XXXXXXX XXXX XX XXX XXXX XXXXXXX XX XXXXXX
XXXXXXXXXX XXXXXXX XXX XXX                 XXXXXXX XX XXX XXXXXXX XXXX XX XXX XXXX XXXXXXX XX XXXXXX
XXXXXXXXXXBXXXXXXX XXX XXX XX XXXX XXX XXX XXXXXXX XX XXX XXXXXXX XXXX XX XXX XXXX XXXXXXX XX XXXXXX
XXXXXXXXXX XXXXXXX XXX XXX XX XXXX XXX XXX XXXXXXX XX XXX XXXXXXX XXXX XX XXX XXXX XXXXXXX XX XXXXXX
XXXXXXXXXX XXXXXXX XXX XXX XX XXXX XX   X  XXXXXXX XX XXX XXXXXXX XXXX                     XX XXXXXX
XXXXXXXXXX XXXXXXX XXX XXX                 XXXXXXX XX XXX XXXXXXX XXXX XXX XX XXX XXXXXXXX XX XXXXXX
XXXXXXXXXX XXXXXXX XXX XXX XX XXXX XXX XX  XXXXXXX XX XXX XXXXXXX XXXX XXX XX XXX XXXXXXXX XX XXXXXX
XXXXXXXXXX XXXXXXX XXX XXX XX XXXX XXX XXX XXXXXXX XX XXX XXXXXXX XXXX XXX XX XXX XXXXXXXX XX XXXXXX
XXXXXXXXXX XXXXXXX XXX XXX XX XXXX XXX XXX            XXX XXXXXXX XXXX        XXX XXXXXXXX         X
XXXXXXXXXX XXXXXXX XXX XXX XX XXXX XXX XXX XXXXXXX XX XXX XXXXXXX XXXX XXX X      XXXXXXXX XX XXXX X
XXXXXXXXXX XXXXXXX XXX XXX XX XXXX XXX XXX XXXXXXX XX XXX XXXXXXX XXXX XXX XX XXX XXXXXXXX XX XXXX X
XXXXXXXXXX XXXXXXX XXX XXX XX XXX  XXX XXX XXXXXXX XX XXX XXXXXXX XXXX XXX XX XXX XXXXXXXX XX XXXX X
X                                                                      XXX XX XXX XXXXXXXX XX XXXX X
XXXXXXXXXXXXX   XX XXXXXXX XXXXXX XXXX XXXXXXXXXXXXXXXXXXXXX   XX  XXX XXX        XXXXXXXX         X
XXXXXXXXXXXXXX XXX XXXXXXX XXXXXX XXXX XXXXXXXXXXXXXXXXXXXXXX  XXX XXX XXX XX XXX XXXXXXXX XX XXXX X
XXXXXXXXXXXXXX XX  XXXXXXX XXXXXX XXX  XXXXXXXXXXXXXXXXXXXXXXX XXX XXX XXX XX XXX XXXXXXXX XX XXXX X
XXXXXXXXXXXXXX     XXXXXXX XXXXXX      XXXXXXXXXXXXXXXXXXXXXXX XXX XXX XXX XX XXX XXXXXXXX XX XXXX X
XXXXXXXXXXXXXX XX  XXXXXXX XXXXXX XXX                              XXX XXX        XXXXXXXX XX XXXX X
XXXXXXXXXXXXXX XXX XXXXXXX XXXXXX XXXX XXXXXXXXXX XXXXXXXXXXXX XXX XXX XXX XX XXX XXXXXXXX XX XXXX X
XXXXXXXXXXXXXX XXX XXXXXXX XXXXXX XXXX XXXXXXXXXX XXXXXXXXXXXX XXX XXX XXX XX XXX XXXXXXXX XX XXXX X
XXXXXXXXXXXXXX XXX XXXXXXX XXXXXX XXXX XXXXXXXXXX XXXXXXXXXXXX XXX XXX XXX XX XXX XXXXXXXX XX XXXX X
XXXXXXXXXXXXXX XXX XXXXXXX                                         XXX XXX XX XXX XXXXXXXX XX XXXX X
XXXXXXXXXXXXXX XXX XXXXXXX XXXXXXXXXXX XXX XXXXXX  XXXXXXXXXXXXXXX XXX XXX XX XXX XXXXXXXX XX XXXX X
XXXXXXXXXXXXXX XXX XXXXXXX XXXXXXXXXXX XXX XXXXXXX XXXXXXXXXXXXXXX XXX XXX XX XXX XXXXXXXX XX XXXX X
XXXXXXXXXXXXXX XXX XXXXXXX XXXXXXXXXXX             XXXXXXXXXXXXXXX XXX        XXX XXXXXXXX XX XXXX X
XXXXXXXXXXXXXX XXX XXXXXXX XXXXXXXXXXX XXX XXXXXXX XXXXXXXXXXXXXXX XXX XXX XX XXX XXXXXXXX XX XXXX X
XXXXXXXXXXXXXX XXX XXXXXXX XXXXXXXXXXX XXX XXXXXXX XXXXXXXXXXXXXXX XXX XXX XX XXX XXXXXXXX XX XXXX X
XXXXXXXXXXXXXX XXX XXXXXXX XXXXXXXXXXX XXX XXXXXXX XXXXXXXXXXXXXXX XXX XXX XX XXX XXXXXXXX XX XXXX X
XXXXXXXXXXXXXX XXX XXXXXXX XXXXXXXXXXX                             XXX XXX XX XXX XXXXXXXX XX      X
XXXXXXXXXXXXXX XXX XXXXXXX XXXXXXXXXXX XX   XXXXXX XXXXXXXXXXXXXXX XXX XXX XX XXX XXXXXXXX XX XXXX X
XXXXXXXXXXXXXX XXX XXXXXXX XXXXXXXXXXX XXX XXXXXXX XXXXXXXXXXXXXXX XXX XXX XX XXX XXXXXXXX XX XXXX X
XXXXXXXXXXXXXX XXX XXXXXXX XXXXXXXXXXX XXX XXXXXXX XXXXXXXXXXXXXXX XXX XXX XX XXX  XXXXXXX XX XXXXCX
XXXXXXXXXXXXXX XXX XXXXXXX                                             XXX XX XXX a        XX XXXX X
XXXXXXXXXXXXXX XXX XXXXXXX XXXXXXXXXXXXXXXXXXXXX   XXXXXX XXXXXXXX XXX XXX XX XXX  XXXXXXX         X
XXXXXXXXXXXXXX XXX XXXXXXX XXXXXXXXXXXXXXXXXXXXXX XXXXXXX XXXXXXXX XXX XXX XX XXX XXXXXXXX XX XXXX X
XXXXXXXXXXXXXX XXX XXXXXXX XXXXXXXXXXXXXXXXXXXXXX XXXXXXX XXXXXXXX XXX XXX XX XXX XXXXXXXX XX XXXX X
XXXXXXXXXXXXXX XXX XXXXXXX                                         XXX XXX        XXXXXXXX XX XXXX X
XXXXXXXXXXXXXX XXX XXXXXXX XXXXXXXXXXXXXXXXXXXXXXXXXXXXXX XXXXXXXX XXX XXX XX XXX XXXXXXXX XX XXXX X
XXXXXXXXXXXXXX XXX XXXXXXX XXXXXXXXXXXXXXXXXXXXXXXXXXXXXX XXXXXXXX XXX XXX XX XXX XXXXXXXX XX XXXX X
XXXXXXXXXXXXXX XX  XXXXXXX XXXXXXXXXXXXXXXXXXXXXXXXXXXXXX XXXXXXXX XXX XXX XX XXX XXXXXXXX XX XXXX X
XXXXXXXXXXXXXX     XXXXXXX XXXXXXXXXXXXXXXXXXXXXXXXXXXXXX XXXXXXXX XX  XXX XX XXX XXXXXXXX XX  XXX X
XXXXXXXXXXXXXX XX  XXXXXXX XXXXXXXXXXXXXXXXXXXXXXXXXXXXXX XXXXXXXX     XXX XX              XX      X
XXXXXXXXXXXXXX XXX XXXXXXX XXXXXXXXXXXXXXXXXXXXXXXXXXXXXX XXXXXXXX XX  XXX XX XXX XXXXXXXX XX  XXX X
XXXXXXXXXXXXXX XXX XXXXXXX XXXXXXXXXXXXXXXXXXXXXXXXXXXXXX XXXXXXXX XXX XXX XX XXX XXXXXXXX XX XXXX X
X                                                                         T                XX XXXX X
XXXXXXXXXXXXX XXXXXXXXXXXXXXXXXXXX XXX XXXXXXXXXXXXXXX XXXXXXXXXXXXXXXeXXXXXXXXXX   XXXXXX XX XXXX X
XXXXXXXXXXXXX XXXXXXXXXXXXXXXXXXXX XXX XXXXXXXXXXXXXXX XXXXXXXXXXXXXXX XXXXXXXXXXX XXXXXXX XX XXXX X
XXXXXXXXXXXXX XXXXXXXXXXXXXXXXXXXX XXX XXXXXXXXXXXXXXX XXXXXXXXXXXXXXX XXXXXXXXXXX XXXXXXX XX  XXX X
XXXXXXXXXXXX   XXXXXXXXXXXXXXXXXXX XX   XXXXXXXXXXXXXX XXXXXXXXXXXXXXX XXXXXXXXXXX XXXXXX  XX      X
X                                                                      XXXXXXXXXXX         XX  XXXXX
XXXXXXXXXXXXXXXXXXXXXXXXXXXXXXXXXXXXXXXXXXXXXXXXXXXXXXXXXXXXXXXXXXXXXXXXXXXXXXXXXXXXXXXXXXXXXXXXXXXX