XXXXXXXXXXXXXXXXXXXXXXXXXXXXXXXXXXXXXXXXXXXXXXXXXXXXXXXXXXXXXXXXXXXXXXXXXXXXXXXXXXXXXXXXXXXXXXXXXXXX
X                                          XXXXXXXXXXXXXXXXXXXXXXXXXXXXXXXXXXXXXX XXXX XX XXXXXXX XX
XXXXX XXXX XXXXXX XXXXXXXXXXXXXXXX XXXXXX                 c                           eXX          X
XXXXX XXXX XXXXXX XXXXXXXXXXXXXXXX XXXXXX  XX XXXX XXXXXXXXXXXXXXXXXXXXXXXXXXXXXX XXXX XX XXXXXXX XX
XXXXX XXXX XXXXXX XXXXXXXXXXXXXXXX XXXXXX XXX XXXX XXXXXXXXXXXXXXXXXXXXXXXXXXXXXX XXXX XX XXXXXXX XX
XXXXX XXXX XXXXXX XXXXXXXXXXXXXXXX XXXXX   XX XXXX XXXXXXXXXXXXXXXXXXXXXXXXXXXXXX XXXX XX XXXXXXX XX
X                                                                                                  X
XX XX XXXX XXXXXXXXXX XXXXXXXXXXXXXXXXXXX XXX XXXX XXXXXXXXXXXXXXXXXXXHXXXXXXX XXXXXXX XX XXXXXXXXXX
XX XX XXXX XXXXXXXXXX XXXXXXXXXXXXXXXXXXX  XX XXXX XXXXXXXXXXXXXXXXXXX XXXXXXX XXXXXXX XX XXXXXXXXXX
XX XX XXXX XXXXXXXXXX XXXXXXXXXXXXXXXXXXX     XXX  XXXXXXXXXXXXXXXXXXX XXXXXXX XXXXXXX XX XXXXXXXXXX
XX XX XXXX XXXXXXXXXX XXXXXXXXXXXXXXXXXXX  XX                                  XXXXXXX XX XXXXXXXXXX
XX XX XXXX XXXXXXXXXX XXXXXXXXXXXXXXXXXXX XXX XXX  XXXXXXXXXXXXXXXXXXX XXXXXXX XXXXXXX XX XXXXXXXXXX
XX XX XXXX XXXXXXXXXX XXXXXXXXXXXXXXXXXXX XXX XXXX XXXXXXXXXXXXXXXXXXX XXXXXXX XXXXXXX XX XXXXXXXXXX
X     XXXX XXXXXXXXXX XXXXXXXXXXXXXXXXXXX XXX XXXX                                     XX XXXXXXXXXX
XX XX                 XXXXXXXXXXXXXXXXXXX XXX XXXX XXXXXXXXXXXXXXXXXXXXXXXXXXX XXXXXXX XX XXXXXXXXXX
XX XX XXXX XXXXXXXXXX XXXXXXXXXXXXXXXXXXX XXX XXXX XXXXXXXXXXXXXXXXXXXXXXXXXXX XXXXXXX XX XXXXXXXXXX
XX XX XXXX XXXXXXXXXX XXXXXXXXXXXXXXXXXXX XXX XXXX XXXXXXXXXXXXXXXXXXXXXXXXXXX XXXXXXX XX XXXXXXXXXX
X         d                             E                                              XX XXXXXXXXXX
XXXXXXXXXX XXXXXXXXXX XXXXXXXXXXXXXXXXXXX XXXXXX   XXXXXXXXXX   XXXXXXXXXXXXXXXXXXXXXX XX XXXXXXXXXX
XXXXXXXXXX XXXXXXXXXX XXXXXXXXXXXXXXXXXXX XXXXXXX XXXXXXXXXXXX XXXXXXXXXXXXXXXXXXXXXXX XX XXXXXXXXXX
XXXXXXXXXX XXXXXXXXXX XXXXXXXXXXXXXXXXXXX XXXXXXX XXXXXXXXXXXX XXXXXXXXXXXXXXXXXXXXXXX XX XXXXXXXXXX
X                                                                                                  X
XXXXXXXXXX XXXXXXXXXXXBXX XXXXXXXXXXXXXXX XXXXXXXXXX   XXXXXXXXXX   XXXXXXXXXX XXX XXXXXX XXXXXXXX X
XXXXXXXXXX XXXXXXXXXXX XX XXXXXXXXXXXXXXX XXXXXXXXXXX XXXXXXXXXXXX XXXXXXXXXXX XXX XXXXXX XXXXXXXX X
XXXXXXXXXX XXXXXXXXXXX XX XXXXXXXXXXXXXXX XXXXXXXXXXX  XXXXXXXXXXX XXXXXXXXXXX XXX XXXXXX XXXXXXXX X
XXXXXXXXXX XXXXXXXXXXX XX XXXXXXXXXXXXXXX XXXXXXXXXXX              XXXXXXXXXXX XXX XXXXXX          X
XXXXXXXXXX                XXXXXXXXXXXXXXX XXXXXXXXXXX  XXXXXXXXXXX XXXXXXXXXXX XXX XXXXXX XXX XXXX X
XXXXXXXXXX XXXXXXXXXXX XX XXXXXXXXXXXXXXX XXXXXXXXXXX XXXXXXXXXXXX XXXXXXXXXXX XXX XXXXXX XXX XXXX X
XXXXXXXXXX XXXXXXXXXXX XX XXXXXXXXXXXXXXX XXXXXXXXXXX XXXXXXXXXXXX XXXXXXXXXXX XXX XXXXXX XXX XXXX X
X                         XXXXXXXXXXXXXXX XXXXXXXXXXX XXXXXXXXXXXX XXXXXXXXXX  XXX XXXXXX XXX XXXX X
XXXXXXXXXXXXX   X   XX XX XXXXXXXXXXXXXXX XXXXXXXXXXX XXXXXXXXXXXX                        XXX XXXX X
XXXXXXXXXXXXXX XXX XXX XX XXXXXXXXXXXXXXX XXXXXXXXXXX XXXXXXXXXXXX XXXXXXXXXX  XXX XXXXXX XXX XXXX X
XXXXXXXXXXXXXX XXX XXX XX XXXXXXXXXXXXXXX XXXXXXXXXXX XXXXXXXXXXXX XXXXXXXXXXX XXX XXXXXX XXX XXXX X
X                                                                              XXX XXXXXX XXX XXXX X
XXXXXXXXX XXXXXXXXXXXXXXX XXXXXXX XXXXXXX XXXX XXXXXXXXX   XX XXXX XXXXXXXXXXX XXX XXXXXX XXX XXXX X
XXXXXXXXX XXXXXXXXXXXXXXX XXXXXXX XXXXXXX XXXX XXXXXXXXXX XXX XXXX XXXXXXXXXXX XXX XXXXXX XXX XXXX X
XXXXXXXXX XXXXXXXXXXXXXXX XXXXXXX XXXXXXX XXXX XXXXXXXXXX XXX XXXX XXXXXXXXXXX XXX XXXXXX XXX XXXX X
XXXXXXXXX XXXXXXXXXXXXXXX XXXXXXX XXXXXXX XXXX XXXXXXXXXX XXX XXXX XXXXXXXXXXX XXX XXXXXX XXX XXXX X
XXXXXXXXX XXXXXXXXXXXXXXX XXXXXXX XXXXXXX XXXX XXXXXXXXXX XXX                  XXX XXXXXX          X
XXXXXXXXX XXXXXXXXXXXXXXX XXXXXXX XXXXXXX XXXX XXXXXXXXXX XXX XXXX XXXXXX XXXX XXX XXXXXX XXX XXXX X
XXXXXXXXX XXXXXXXXXXXXXXX XXXXXXX XXXXXXX XXXX XXXXXXXXXX XXX XXXX XXXXXX XXXX XXX XXXXXX XXX XXXX X
XXXXXXXXX XXXXXXXXXXXXXXX XXXXXXX XXXXXXX XXXX XXXXXXXXXX XXX XXXX XXXXXX XXXX XXX XXXXXX XXX XXXX X
XXXXXXXXX XXXXXXXXXXXXXXX XXXXXXX XXXXXXX XXXX XXXXXXXXXX XXX XXXX             XXX XXXXXX XXX XXXX X
XXXXXXXXX XXXXXXXXXXXXXXX XXXXXXX XXXXXXX XXXX XXXXXXXXXX XXX XXXX XXXXXX XXXX XXX XXXXXX XXX XXXX X
XXXXXXXXX XXXXXXXXXXXXXXX XXXXXXX XXXXXXX XXXX XXXXXXXXXX XXX XXXX XXXXXX XXXX XXX XXXXXX XXX XXXX X
XXXXXXXXX XXXXXXXXXXXXXXX XXXXXXX XXXXXXX XXXX XXXXXXXXXX XXX XXXX XXXXXX XXXX XXX XXXXXX XXX XXXX X
XXXXXXXXX XXXXXXXXXXXXXXX XXXXXXX XXXXXXX XXXX XXXXXXXXXX XXXaXXXX XXXXXX XXXX XXX XXXXXX XXX XXXX X
XXXXXXXXX XXXXXXXXXXXXXXX XXXXXXX XXXXXXX XXXX XXXXXXXXXX XXX XXXX XXXXXX XXXX XXX XXXXXX XXX XXXX X
XXXXXXXXX XXXXXXXXXXXXXXX XXXXXXX XXXXXXX XXXX XXXXXXXXXX XXX XXXX XXXXXX XXXX XXX XXXXXX XXX XXXX X
XXXXXXXXX XXXXXXXXXXXXXXX XXXXXXX XXXXXXX XXXX XXXXXXXXXX XXX XXXX     f                  XXX XXXX X
X                                                             XXXX XXX XXXXXXX XXX XXX XX XXX XXXX X
XXXXXXXXX XXXXXXXXXXXXXXX XXXXXXX XXXX XX XXXX XXXXXXXXXXXXXX XXXX XXX XXXXXXX XXX XXX XX XXX XXXX X
XXXXXXXXX XXXXXXXXXXXXXXX XXXXXXX XXXX XX XXXX XXXXXXXXXXXXXX XXXX XXX XXXXXXX XXX XXX XX XXX XXXX X
XXXXXXXXX XXXXXXXXXXXXXXX XXXXXXX XXXX XX                          XXX XXXXXXX XXX XXX XX XXX XXXX X
XXXXXXXXX XXXXXXXXXXXXXXX XXXXXXX XXXX XX XXXXXXXXXXXXXXXX XX XXXX XXX XXXXXXX XXX XXX XX          X
XXXXXXXXX XXXXXXXXXXXXXXX XXXXXXX XXXX XX XXXXXXXXXXXXXXXX XX XXXX XXX XXXXXXX XXX XXX XX XXX XXXX X
XXXXXXXXX XXXXXXXXXXXXXXX  XXXXXX XXXX XX XXXXXXXXXXXXXXXX XX XXXX XXX XXXXXXX XXX XXX XX XXX XXXX X
XXXXXXXXX XXXXXXXXXXXXXXX    D    XXXX XX XXXXXXXXXXXXXXXX XX XXXX XXX XXXXXXX XXX        XXX XXXX X
XXXXXXXXX XXXXXXXXXXXXXXX  XXXXXX XXXX XX XXXXXXXXXXXXXXXX XX XXXX XXX XXXXXXX XXX XXX XX XXX XXXX X
XXXXXXXXX XXXXXXXXXXXXXXX XXXXXXX XXXX XX XXXXXXXXXXXXXXXX XX XXXX XXX XXXXXXX XXX XXX XX XXX XXXX X
XXXXXXXXX XXXXXXXXXXXXXXX XXXXXXX XXXX XX XXXXXXXXXXXXXXXX XX XXXX XXX XXXXXXX XXX XXX XX XXX XXXX X
XXXXXXXXX XXXXXXXXXXXXXXX XXXXXXX                             XXX  XXX XXXXXXX XXX XXX XX XXX XXXX X
XXXXXXXXX XXXXXXXXXXXXXXX XXXXXXX XXXX XX XXXXXXXX XX   XX XX      XXX XXXXXXX XXX XXX XX XXX XXXX X
XXXXXXXXX XXXXXXXXXXXXXXX XXXXXXX XXXX XX XXXXXXXXbXXX XXX XX XXX  XXX XXXXXXX XXX XXX XX XXX XXXX X
XXXXXXXXX XXXXXXXXXXXXXXX  XXXXXX XXXX XX XXXXXXXX XXX XXX XX XXXX XXX XXXXXXX XX  XXX XX XXX XXXX X
XXXXXXXXX XXXXXXXXXXXXXXX   XXXXX XXXX XX XXXXXXX   XX XXX XX XXXX XX   XXXXXX X   XXX XX XXX XXXX X
X                                                                                                  X
XXXXXXXXXXXXX XXXXXXXXXXXXXXXXXXXXXXXXXXXXXXXXXXXXXXXXXXX XXXXXXXX XXXXXXXXXXX XXX XX  XX XXX  XXX X
XXXXXXXXXXXXX XXXXXXXXXXXXXXXXXXXXXXXXXXXXXXXXXXXXXXXXXXX XXXXXXXX XXXXXXXXXXX XXX XX XXX XXXX XXX X
XXXXXXXXXXXXX XXXXXXXXXXXXXXXXXXXXXXXXXXXXXXXXXXXXXXXXXXX XXXXXXXX XXXXXXXXXXX XXX XX XXX XXXX XXX X
X                                                         XXXXXXXX XXXXXXXXXXX XXX XX XXX          X
XXXXXXXXXXXXX XXXXXXXX XXXXXXXXXXXXXXXXXXXXXXXXXXXXXXXXXX XXXXXXXX XXXXXXXXXXX XXX XX XXX XXXX XXX X
XXXXXXXXXXXXX XXXXXXXX XXXXXXXXXXXXXXXXXXXXXXXXXXXXXXXXXX XXXXXXXX XXXXXXXXXXX XXX XX XXX XXXX XXX X
X                                                                  XXXXXXXXXXX XXX XX XXX XXXX XXX X
XXXXX XXXXXXXXXXXXXXXX XXXXXXX XXXXXXXXXXXXXX XXXXXXXXXXX XXX   XX XXXXXXXXXXX XXX XX XXX XXXX XXX X
XXXXX XXXXXXXXXXXXXXXX XXXXXXX XXXXXXXXXXXXXX XXXXXXXXXXX XXXX XXX XXXXXXXXXXX XXX XX XXX XXXX XXX X
XXXXX XXXXXXXXXXXXXXXX XXXXXXX XXXXXXXXXXXXXX XXXXXXXXXXX XXXX XXX XXXXXXXXXXX XXX XX XXX XXXX XXX X
XXXXX XXXXXXXXXXXXXXXX XXXXXXX XXXXXXXXXXXXXX XXXXXXXXXXX XXXX      XXXXXXXXXX XXX XX XXX XXXX XXX X
XXXXX                                         XXXXXXXXXXX XXXX XXX            g    XX XXX XXXX XXX X
XXXXX XXXXXXXXXXXXXXXX XXXXXXX XXXXXXXXXXXXXX XXXXXXXXXXX XXXX XXX XXXXXXXXXXX XXX XX XXX XXXX XXX X
XXXXX XXXXXXXXXXXXXXXX XXXXXXX XXXXXXXXXXXXXX XXXXXXXXXXX XXXX XXX XXXXXXXXXXX XXX XX XXX XXXX XXX X
XXXXX XXXXXXXXXXXXXXXX XXXXXXX XXXXXXXXXXXXXX XXXXXXXXXXX XXXX XXX XXXXXXXXXXX XXX XX XXX XXXX XXX X
XXXXX XXXXXXXXXXXXXXXX XXXXXXX                            XXXX XXX            G                XXX X
XXXXX XXXXXXXXXXXXXXXX XXXXXXX XXXXXXXXXXXXXX XXXXXXXXXXX XXXX XXX XXXXXXXXXX XXXX XX XXX XXXX XXX X
XXXXX XXXXXXXXXXXXXXXX XXXXXXX XXXXXXXXXXXXXX XXXXXXXXXXX XXXX XXX XXXXXXXXXX XXXX XX XXX XXXX XXX X
XXXXX XXXXXXXXXXXXXXXX XXXXXXX XXXXXXXXXXXXXX XXXXXXXXXXX XXXX XXX XXXXXXXXXX XXXX XX XXX XXXX XXX X
XXXXX                                      T    h         XXXX XXX                 XX XXXFXXXX XXX X
XXXXX XXXXXXXXXXX XXXXXXXXXXXX XXXXXXXXXX XXX XXXXXXXXXXX XXXX XXX XX XXX XXX XXXX XX XXX XXXX XXX X
XXXXX XXXXXXXXXXX XXXXXXXXXXXX XXXXXXXXXX XXX XXXXXXXXXXX XXXX XXX XX XXX XXX XXXX XX XXX XXXX XXX X
XXXXX                                         XXXXXXXXXXX XXXX XXX XX         XXXX XX XXX XXXX XXX X
XXXXX XXXXXXXXXXX XXXXXXXXXXXX XXXXXXXXXX XXX XXXXXXXXXXX XXXX XXX XX XXX XXX XXXX XX XXX XXXX XXX X
XXXXX XXXXXXXXXXX XXXXXXXXXXXX XXXXXXXXXX XXX XXXXXXXXXXX XXXX XXX XX XXX XXX XXXX XX XXX XXXX XXX X
XXXXX XXXXXXXXXXX XXXXXXXXXXXX XXXXXXXXXX XXX XXXXXXXXXXX XXXX XXX XX XXX XXX XXXX XX XXX XXXX XXX X
XXXXX XXXXXXXXXXX XXXXXXXXXXXX XXXXXXXXXX XXX XXXXXXXXXXX XXXX XXX            XXXX XX XXX          X
XXXXX                                         XXXXXXXXXXX     A    XX XXXXXXX XXXX XX XXX XXXXXXXX X
XXXXX XXXXXXXXXXXXXXXXXXXXXXXX XXXXXXXXXXXXXX XXXXXXXXXXX XXXX XXX XX XXXXXXX XXXX XX XXX XXXXXXXX X
XXXXX XXXXXXXXXXXXXXXXXXXXXXXX XXXXXXXXXXXXXX XXXXXXXXXXX XXX  XXX XX  XXXXXX XXXX XX XXX XXXXXXXX X
XXXXX XXXXXXXXXXXXXXXXXXXXXXXX XXXXXXXXXXXXXX XXXXXXXXXXX XX   XX  XX   XXXXX XXXX XX XXX XXXXXXXX X
X                        C                                                                XXXXXXXX X
XXXXXXXXXXXXXXXXXXXXXXXXXXXXXXXXXXXXXXXXXXXXXXXXXXXXXXXXXXXXXXXXXXXXXXXXXXXXXXXXXXXXXXXXXXXXXXXXXXXX