XXXXXXXXXXXXXXXXXXXXXXXXXXXXXXXXXXXXXXXXXXXXXXXXXXXXXXXXXXXXXXXXXXXXXXXXXXXXXXXXXXXXXXXXXXXXXXXXXXXX
X                             XXXXXXXXXXXXXXXXXXXXXXXXXXXXXXX          XX             XXXX XXXXXXXXX
XXXXXXXXXXXXXXXXXX XXXXXXX XX XXXXXXXXXXXXXXXXXXXXXXXXXXXXXXX  XXXXXX      XXXXXX XXX              X
XXXXXXXXXXXXXXXXXX XXXXXXX XX XXXXXXXXXXXXXXXXXXXXXXXXXXXXXXX XXXXXXXX XX  XXXXXX XXX XXXX XXXXXXXXX
XXXXXXXXXXXXXXXXXX XXXXXXX XX XXXXXXXXXXXXXXXXXXXXXXXXXXXXXXX XXXXXXXX XXX XXXXXX XXX XXXX XXXXXXXXX
XXXXXXXXXXXXXXXXXX XXXXXXX XX XXXXXXXXXXXXXXXXXXXXXXXXXXXXXXX XXXXXXXX XXX XXXXXX XXX XXXX XXXXXXXXX
XXXXXXXXXXXXXXXXXX XXXXXXX XX XXXXXXXXXXXXXXXXXXXXXXXXXXXXXXX XXXXXXXX XXX XXXXXX XXX XXXX XXXXXXXXX
XXXXXXXXXXXXXXXXXX XXXXXXX XX XXXXXXXXXXXXXXXXXXXXXXXXXXXXXXX XXXXXXXX XXX XXXXXX XXX XXXX XXXXXXXXX
XXXXXXXXXXXXXXXXXX XXXXXXX XX XXXXXXXXXXXXXXXXXXXXXXXXXXXXXXX XXXXXXXX XXX XXXXXX XXX XXXX XXXXXXXXX
X                                                             XXXXXXX  XX  XXXXXX XXX XXXX XXXXXXXXX
XXXXXXXXXXXXXXXXXXXXXXXXXXXXX XXXXXXXXXXXXXXXXXXXXXXXXXXXXXXX              XXXXXX XXX XXXX XXXXXXXXX
XXXXXXXXXXXXXXXXXXXXXXXXXXXXX XXXXXXXXXXXXXXXXXXXXXXXXXXXXXXX XXXXXXX  XX  XXXXXX XXX XXXX XXXXXXXXX
XXXXXXXXXXXXXXXXXXXXXXXXXXXXX XXXXXXXXXXXXXXXXXXXXXXXXXXXXXXX XXXXXXXX XXX XXXXXX XXX XXXX XXXXXXXXX
XXXXXXXXXXXXXXXXXXXXXXXXXXXXX XXXXXXXXXXXXXXXXXXXXXXXXXXXXXXX XXXXXXXX XXX XXXXXX XXX XXXX XXXXXXXXX
X                                                                          XXXXXX XXX XXXX XXXXXXXXX
XXXXXX XXXXXXXXXXXXXX XXXXXXXXXXXX XXXXXXX XXXXXXX XXXXXXXXXX XXXXXXXX XXX XXXXXX XXX XXXX XXXXXXXXX
XXXXXX XXXXXXXXXXXXXX XXXXXXXXXXXX XXXXXXX XXXXXXX XXXXXXXXXX XXXXXXXX XXX XXXXXX XXX XXXX XXXXXXXXX
XXXXXX XXXXXXXXXXXXXX XXXXXXXXXXXX XXXXXXX                    XXXXXXXX XXX                         X
X                                          XXXXXXX XXXXXXXXXX XXXXXXXX XXX XXXXXXXXXX XXXXXXXXXXXXXX
XXXXXX XXXXXXXXXXXXXX XXXXXXXXXXXX XXXXXXX XXXXXXX XXXXXXXXXX XXXXXXXX XXX XXXXXXXXXX XXXXXXXXXXXXXX
XXXXXX XXXXXXXXXXXXXX XXXXXXXXXXXX XXXXXXX XXXXXXX XXXXXXXXXX XXXXXXXX XXX XXXXXXXXXX XXXXXXXXXXXXXX
X                                                             XXXXXXXX XXX XXXXXXXXXX XXXXXXXXXXXXXX
XXXXXXXXXXXXXXXXXXXX   XXXXXX XXX XXXX XXX XXXXXXXXXXXXXXXXXX XXXXXXXX                XXXXXXXXXXXXXX
XXXXXXXXXXXXXXXXXXXXX XXXXXXX XXX XXXX XXX XXXXXXXXXXXXXXXXXX XXXXXXXX XXX XXXXXXXXXX XXXXXXXXXXXXXX
XXXXXXXXXXXXXXXXXXXXX XXXXXXX XXX XXXX XXX XXXXXXXXXXXXXXXXXX XXXXXXXX XXX XXXXXXXXXX XXXXXXXXXXXXXX
X                                                                                                  X
XXXXX XXXXXXX   XXXXX XXXXXXX XXX XXXX XXXXXXXXXXX XXXXXXXXXXXXXXX XXXXXXX XX XXX XXXX X   XXXXXXX X
XXXXX XXXXXXXX XXXXXX XXXXXXX XXX XXXX XXXXXXXXXXX XXXXXXXXXXXXXXX XXXXXXX XX XXX XXXX XX XXXXXXXX X
XXXXX XXXXXXXX XXXXXX XXXXXXX XXX XXXX XXXXXXXXXXX XXXXXXXXXXXXXXX XXXXXXX XX XXX XXXX XX XXXXXXXX X
XXXXX XXXXXXXX XXXXXX XXXXXXX XXX XXXX XXXXXXXXXXX XXXXXXXXXXXXXXX XXXXXXX XX XXX XXXX XX XXXXXXXX X
XXXXX XXXXXXXX XXXXXX                                                             XXXX XX XXXXXXXX X
XXXXX XXXXXXXX XXXXXX XXXXXXXXXXX XXXXXXXXXXXXXXXX XXXXXXXXXXXXXXX XXXXXXX XX XXX XXXX XX XXXXXXXX X
XXXXX XXXXXXXX XXXXXX XXXXXXXXXXX XXXXXXXXXXXXXXXX XXXXXXXXXXXXXXX XXXXXXX XX XXX XXXX XX XXXXXXXX X
XXXXX XXXXXXXX                                                     XXXXXXX             XX XXXXXXXX X
XXXXX XXXXXXXX XXX XX XXXXXXXXXXXXXXXXXXXXXXXXXXXXXXXXXXX XXXXXXXX XXXXXXX XXXXXX XXXX XX XXXXXXXX X
XXXXX XXXXXXXX XXX XX XXXXXXXXXXXXXXXXXXXXXXXXXXXXXXXXXXX XXXXXXXX XXXXXXX XXXXXX XXXX XX XXXXXXXX X
XXXXX XXXXXXXX XXX XX XXXXXXXXXXXXXXXXXXXXXXXXXXXXXXXXXXX XXXXXXXX XXXXXXX XXXXXX XXXX XX XXXXXXXX X
XXXXX XXXXXXXX XXX XX XXXXXXXXXXXXXXXXXXXXXXXXXXXXXXXXXXX                                          X
XXXXX XXXXXXXX XXX XX XXXXXXXXXXXXXXXXXXXXXXXXXXXXXXXXXXX XXXXXXXX XXXXXXX XXX XXXXXXX XXXXXXX XXX X
XXXXX XXXXXXXX XXX XX XXXXXXXXXXXXXXXXXXXXXXXXXXXXXXXXXXX XXXXXXXX XXXXXXX XXX XXXXXXX XXXXXXX XXX X
XXXXX XXXXXXXX XXX XX XXXXXXXXXXXXXXXXXXXXXXXXXXXXXXXXXXX XXXXXXXX XXXXXXX XXX XXXXXXX XXXXXXX XXX X
X                     XXXXXXXXXXXXXXXXXXXXXXXXXXXXXXXXXXX XXXXXXXX XXXXXX  XXX XXXXXXX XXXXXXX XXX X
XXXXX XXXXXXXX XXX XX                                                      XXX XXXXXXX XXXXXXX XXX X
XXXXX XXXXXXXX XXX XX XXXXXXX XXXXXXXXXXXXXXXXXXXXXXXXXXX XXXXXXXX XXXXXX  XXX XXXXXXX XXXXXXX XXX X
XXXXX XXXXXXXX XXX XX XXXXXXX XXXXXXXXXXXXXXXXXXXXXXXXXXX XXXXXXXX XXXXXXX XXX XXXXXXX XXXXXXX XXX X
XXXXX XXXXXXXX XXX XX XXXXXX   XXXXXXXXXXXXXXXXXXXXXXXXXX XXXXXXXX XXXXXXX XXX XXXXXXX XXXXXXX XXX X
X                                                                          XXX XXXXXXX XXXXXXX XXX X
XX XX XXXXXXX XXXXXXXX XX XXXX XXXXXX XXXXXXXX XXXXXX XXX XXXX XXX XX XXXX XXX XXXXXXX XXXXXXX XXX X
X  XX XXXXXXX  XXXXXXX XX XXXX XXXXXX XXXXXXXX XXXXXX XXX XXXX XXX XX XXXX XXX XXXXXXX XXXXXXX XXX X
X                      XX             XXXXXXXX XXXXXX XXX XXXX XXX XX XXXX             XXXXXXX XXX X
X  XX XXXXXXX  XXXXXXX XX XXXX XXXXXX XXXXXXXX XXXXXX          XXX XX XXXX XXX XXXXXXX XXXXXXX XXX X
XX XX XXXXXXX XXXXXXXX XX XXXX XXXXXX XXXXXXXX XXXXXX XXX XXXX XXX XX XXXX XXX XXXXXXX XXXXXXX XXX X
XX XX XXXXXXX XXXXXXXX XX XXXX XXXXXX XXXXXXXX XXXXXX XXX XXXX XXX XX XXXX XXX XXXXXXX XXXXXXX XXX X
XX XX XXXXXXX XXXXXXXX XX XXXX XXXXXX XXXXXXXX XXXXXX              XX XXXX XXX XXXXXXX XXXXXXX XXX X
XX XX XXXXXXX XXXXXXXX XX XXXX XXXXXX XXXXXXXX XXXXXX XXXXXXXX XXX XX XXXX XXX XXXXXXX XXXXXXX XXX X
XX XX XXXXXXX XXXXXXXX XX XXXX XXXXXX XXXXXXXX XXXXXX XXXXXXXX XXX XX XXXX XXX XXXXXXX XXXXXXX XXX X
XX XX XXXXXXX XXXXXXXX XX XXXX XXXXXX XXXXXXXX XXXXXX XXXXXXXX XXX XX XXXX XXX XXXXXXX XXXXXXX XXX X
XX XX XXXXXXX XXXXXXXX XX XXXX XXXXXX XXXXXXXX XXXXXX XXXXXXXX XXX XX XXX  XXX XXXXXXX XXXXXXX XXX X
XX XX                  XX XXXX XXXXXX                 XXXXXXXX XXX         XXX XXXXXXX XXXXXXX XXX X
XX XX XXXXXXX XXXXXXXX XX XXXX XXXXXX XXXXXXXX XXXXXX XXXXXXXX XXX XX XXX  XXX XXXXXXX XXXXXXX XXX X
XX XX XXXXXXX XXXXXXXX XX XXXX XXXXXX XXXXXXXX XXXXXX XXXXXXXX XXX XX XXXX XXX XXXXXXX XXXXXXX XXX X
XX XX XXXXXXX                  XXXXXX XXXXXXXX XXXXXX XXXXXXXX XXX XX XXXX XXX XXXXXXX XXXXXXX XXX X
XX XX XXXXXXX XXX XXXX XX XXXX XXXXXX XXXXXXXX                     XX XXXX             XXXXXXX XXX X
XX XX XXXXXXX XXX XXXX XX XXXX XXXXXX XXXXXXXX XXXXXX XXXXXXXXXXXX XX XXXX XXX XXXXXXX XXXXXXX XXX X
XX XX XXXXXXX XXX XXXX XX XXXX XXXXXX XXXXXXXX XXXXXX XXXXXXXXXXXX XX XXXX XXX XXXXXXX XXXXXXX XXX X
X             XXX XXXX XX XXXX XXXXXX XXXXXXXX XXXXXX XXXXXXXXXXXX XX XXXX             XXXXXXX XXX X
XX XXX XXXXXX XXX XXXX XX XXXX XXXXXX XXXXXXXX XXXXXX XXXXXXXXXXXX XX XXXX XXX XXXXXXX             X
XX XXX XXXXXX XXX XXXX XX XXXX XXXXXX XXXXXXXX XXXXXX XXXXXXXXXXXX XX XXXX XXX XXXXXXX XXXXXXX XXX X
XX XXX XXXXXX XXX XXXX XX  XXX XXXXXX XXXXXXXX XXXXXX XXXXXXXXXXXX XX XXXX XXX XXXXXXX XXXXXXX XX  X
XX XXX XXXXXX XXX XXXX XX             XXXXXXXX XXXXXX XXXXXXXXXXXX XX XXXX XXX XXXXXXX XXXXXXX     X
X                          XXXXXXXXXX                 XXXXXXXXXXXX XX XXXX XXX XXXXXXX XXXXXXX XX  X
XXXXXX XXXXXX XXX XXXXXXX XXXXXXXXXXX XXXXXXXX XXXXXX XXXXXXXXXXXX XX XXXX XXX XXXXXXX XXXXXXX XXX X
XXXXXX XXXXXX  XX XXXXXXX XXXXXXXXXXX XXXXXXXX XXXXXX XXXXXXXXXXXX XX XXXX XXX XXXXXX  XXXXXXX XXX X
XXXXXX XXXXXX     XXXXXXX XXXXXXXXXXX XXXXXXXX                     XX XXXX                         X
XXXXXX XXXXXX  XX XXXXXXX XXXXXXXXXXX XXXXXXXX XXXXXX XXX XXXX XX     XXXX XXXXXXX XX XXXXXXXXXXXX X
XXXXXX XXXXXX XXX XXXXXXX XXXXXXXXXXX XXXXXXXX XXXXXX XXX XXXX XXX XX XXXX XXXXXXX XX XXXXXXXXXXXX X
XXXXXX XXXXXX XXX XXXXXXX XXXXXXXXXXX XXXXXXXX XXXXXX XXX XXXX XXX XX XXXX XXXXXXX XX  XXXXXXXXXXX X
XXXXXX XXXXXX XXX XXXXXXX XXXXXXXXXXX XXXXXXXX XXXXXX  XX XXXX        XXXX XXXXXXX XX   XXXXXXXXXX X
X                                              XXXXXX     XXXX XXX XX XXXX                         X
X XXXXXXXXXXXXXXXXXXXXXXX XXX XXXXXXX XXXXXXXX XXXXXX  XX XXXX XXX XX XXXX XX XXXX XXXXXX XXXX XXX X
X XXXXXXXXXXXXXXXXXXXXXXX XXX XXXXXXX XXXXXXXX XXXXXX XXX XXXX XXX XX XXXX XX XXXX XXXXXX XXXX XXX X
X                                              XXXXXX XXX XXXX XXX XX XXXX         XXXXXX XXXX XXX X
X XXXXXXXXXXXXXXXXXXXXXXXXXXX XXXX XX XX   XX                      XX XXXX XX XXXX             XXX X
X XXXXXXXXXXXXXXXXXXXXXXXXXXX XXXX XX XXX XXXX XXXXXX XXX XXXX XXX XX XXXX XX XXXX XXXXXX XXXX XXX X
X XXXXXXXXXXXXXXXXXXXXXXXXXXX XXXX XX XXX XXXX XXXXXX XXX XXXX XXX XX XXX  XX XXXX XXXXXX XXXX XXX X
X XXXXXXXXXXXXXXXXXXXXXXXXXXX XXXX XX XXX XXXX XXXXXX XXX XXXX XXX XX      XX  XXX                 X
X XXXXXXXXXXXXXXXXXXXXXXXXXXX XXXX XX XXX XXXX XXXXXX XXX XXXX XXX XX XXX  XX      XXXXXXXXXXX XXX X
X XXXXXXXXXXXXXXXXXXXXXXXXXXX XXXX XX XXX XXXX XXXXXX XXX XXXX XXX XX XXXX XX  XXX XXXXXXXXXXX XXX X
X XXXXXXXXXXXXXXXXXXXXXXXXXXX XXXX XX XXX XXXX XXXXXX XXX XXXX XXX XX XXXX XX XXXX XXXXXXXXXXX XXX X
X                                                                  XX XXXX XX XXXX XXXXXXXXXXX XXX X
XXXXXXXXXXXXXXXXXXXXXXXXX XXXXXXXX XXXXXXXXXXX XXXXXXXXXXXXXXXXXXX XX XXXX XX XXXX XXXXXXXXXXX XXX X
XXXXXXXXXXXXXXXXXXXXXXXXX XXXXXXXX XXXXXXXXXXX XXXXXXXXXXXXXXXXXXX XX XXXX XX XXXX XXXXXXXXXXX XXX X
XXXXXXXXXXXXXXXXXXXXXXXXX XXXXXXXX XXXXXXXXXXX XXXXXXXXXXXXXXXXXXX XX XXXX XX XXXX XXXXXXXXXXX XX  X
XXXXXXXXXXXXXXXXXXXXXXXXX                      XXXXXXXXXXXXXXXXXXX XX  XXX                         X
XXXXXXXXXXXXXXXXXXXXXXXXX XXXXXXXX XXXXXXXXXXX XXXXXXXXXXXXXXXXXXX XX      XXXXXXXXXXXXXXXXXXXXXX  X
XXXXXXXXXXXXXXXXXXXXXXXXX XXXXXXXX XXXXXXXXXXX XXXXXXXXXXXXXXXXXXX XX  XXX XXXXXXXXXXXXXXXXXXXXXXX X
XXXXXXXXXXXXXXXXXXXXXXXXX XXXXXXXX XXXXXXXXXXX XXXXXXXXXXXXXXXXXXX XX XXXX XXXXXXXXXXXXXXXXXXXXXXX X
X                 T                            XXXXXXXXXXXXXXXXXXX XX XXXX XXXXXXXXXXXXXXXXXXXXXXX X
XXXXXXXXXXXXXXXXXXXXXXXXX XXXXXXXXXXXXXXXXXXXX XXXXXXXXXXXXXXXXXXX XX XXXX XXXXXXXXXXXXXXXXXXXXXXX X
XXXXXXXXXXXXXXXXXXXXXXXXXXXXXXXXXXXXXXXXXXXXXXXXXXXXXXXXXXXXXXXXXXXXXXXXXXXXXXXXXXXXXXXXXXXXXXXXXXXX