XXXXXXXXXXXXXXXXXXXXXXXXXXXXXXXXXXXXXXXXXXXXXXXXXXXXXXXXXXXXXXXXXXXXXXXXXXXXXXXXXXXXXXXXXXXXXXXXXXXX
XAXXX   XXXXB  XC   XXXXX   XXDXXXXXXXXXXXbXXXXXX XXX XXXXXXXXXXXX                XXX XXX XXXXXXX  X
X                                                 XXX XXXXXXXXXXXX XX XXX XXXXXXX                  X
X XXX XXXX XXX XXXXXXXXXXXXXXX XX XXX XXXX XX XXX XXX XXXXXXXXXXXX XX XXX XXXXXXX XXX XXX XXXXXXX XX
X XXX XXXX XXX XXXXXXXXXXXXXXX XX XXX XXXX XX XXX XXX XXXXXXXXXXXX XX XXX XXXXXXX XXX XXX XXXXXXX XX
X XXX XXXX XX   XXXXXXXXXXXXXX XX XXX XXXX XX XXX XXX XXXXXXXXXXXX XX XXX XXXXXXX XXX XXX XXXXXXX XX
X XXX                                 XXXX XX XXX XXX XXXXXXXXXXXX XX XXX XXXXXXX                 aX
X XXX XXXX XXXXXXXXXXXXXXXXXXX XX XXX XXXX XX XXX XXX XXXXXXXXXXXX XX XXX XXXXXXX XXXX XXXXXXXXXX XX
X XXX XXXX XXXXXXXXXXXXXXXXXXX XX XXX XXXX XX XXX XXX XXXXXXXXXXXX XX XXX XXXXXXX XXXX XXXXXXXXXX XX
X XXX XXXX                                 XX XXX XXX XXXXXXXXXXXX XX XXX XXXXXXX XXXX XXXXXXXXXX  X
X XXX XXXX XXXXXXXXXXXXXXXXXXX XX XXX XXXX        XXX XXXXXXXXXXXX        XXXXXXX                  X
X XXX XXXX XXXXXXXXXXXXXXXXXXX XX XXX XXXX XX XXX XXX XXXXXXXXXXXX XX XXX XXXXXXX XXXX XXXXXXXXXX  X
X XXX XXXX XXXXXXXXXXXXXXXXXXX XX XXX  XXX XX XXX XXX XXXXXXXXXXXX XX XXX XXXXXXX XXXX XXXXXXXXXX XX
X                              XX XXX   XX XX XXX XXX XXXXXXXXXXXX XX XXX XXXXXXX XXXX             X
X XXX XXXXXXXXXX   XXX XXXXX               XX XXX XXX XXXXXXXXXXXX XX XXX XXXXXXX XXXX XXXXXXXXXX XX
X XXX XXXXXXXXXXX XXXX XXXXXX  XXXXXX XXXX XX XXX XXX XXXXXXXXXXXX XX XXX XXXXXXX XXXX XXXXXXXXXX XX
X XXX XXXXXXXXXXX XXX  XXXXXXX XXXXXX XXXX XX XXX XXX XXXXXXXXXXXX XX XXX XXXXXXX XXXX XXXXXXXXXX  X
X XX   XXXXXXXXXX XX   XXXXXXX XXXXXX XXXX XX XXX                                                  X
X                              XXXXXX XXXX        XXXc XXXXXX XXXX XX XXXXXXX   X XXXXXXXXXXX XXX  X
X XXX XXXXXXXXXXX XXXX XXXXXXX XXXXXX XXXX XX XXX XXXX XXXXXX XXXX XX XXXXXXX  XX XXXXXXXXXXX XXXX X
X XXX XXXXXXXXXXX XXXX XXXXXX  XXXXXX XXXX XX XXX XXXX XXXXXX XXXX XX XXXXXXX XXX XXXXXXXXXXX XXXX X
X  XX XXXXXXXXXXX              XXXXXX  XXX XX XXX XXXX XXXXXX XXXX XX XXXXXXX XXX XXXXXXXXXXX XXXX X
X     XXXXXXXXXXX XXXXXXXXXXX  XXXXXX             XXXX             XX XXXXXXX XXX                  X
X XXX XXXXXXXXXXX XXXXXXXXXXXX XXXXXX  XXX XXXXXX XXXX XXXXXX XXXX XX XXXXXXX XXX XXX XXXXXXX XXXXXX
X XXX XXXXXXXXXXX XXXXXXXXXXXX XXXXXX XXXX XXXXXX XXXX XXXXXX XXXX XX XXXXXXX XXX XXX XXXXXXX XXXXXX
X XXX XXXXXXXXXX   XXXXXXXXXXX XXXXXX XXXX XXXXX   XXX XXXXXX XXXX XX XXXXXXX XXX  X   XXXXXX XXXXXX
X                                                                                                  X
X XXXXXXXXXXXXXXX XXXX XX XXXX XX XXXXXXXXXXXXXXXXXXXX XXXXXXXXXX XXXXXXXXXXX XXXX XXXXXX XXXXXXXX X
X XXXXXXXXXXXXXXX XXXX XX XXXX XX XXXXXXXXXXXXXXXXXXXX XXXXXXXXXX XXXXXXXXXXX  XXX XXXXXX XXXXXXXX X
X XXXXXXXXXXXXXXX XXXX XX XXX   X XXXXXXXXXXXXXXXXXXX   XXXXXXXXX  XXXXXXXXXX   XX XXXXX   XXXXXXX X
X                                                                                                  X
X XXXXXXXXXXXXXXXXXXXX XX XXXX XX XXXXXXXXXXXXXXXXXXXXXXXXXXX XXX  XXXXXXXXXXXXXXXXXXXXXXX XX XXXX X
X XXXXXXXXXXXXXXXXXXXX XX XXXX XX XXXXXXXXXXXXXXXXXXXXXXXXXXX XXX XXXXXXXXXXXXXXXXXXXXXXXX XX XXXX X
X XXXXXXXXXXXXXXXXXXXX XX XXXX                                                             XX XXXX X
X XXXXXXXXXXXXXXXXXXXX         XX XXX XXXXXXX XXXXXXXXXXXXXXX XXXXXXXXXXXXXXXXXXXXXXXXXXXX XX XXXX X
X XXXXXXXXXXXXXXXXXXXX XX XXXX XX XXX XXXXXXX XXXXXXXXXXXXXXX XXXXXXXXXXXXXXXXXXXXXXXXXXXX XX XXXX X
X XXXXXXXXXXXXXXXXXXXX XX XXXX XX XXX XXXXXXX XXXXXXXXXXXXXXX XXXXXXXXXXXXXXXXXXXXXXXXXXXX XX XXXX X
X XXXXXXXXXXXXXXXXXXXX XX  XXX XX XX   XXXXXX XXXXXXXXXXXXXXX XXXXXXXXXXXXXXXXXXXXXXXXXXXX XX XXXX X
X XXXXXXXXXXXXXXXXXXXX XX      XX                                                                  X
X XXXXXXXXXXXXXXXXXXXX XX  XXX XX XXXXXXXX XX XXXXXXX XXXXXXXX XXXXXXXXXXXXXXXXXXXXXXXXXXX XX XXXX X
X XXXXXXXXXXXXXXXXXXXX XX XXXX XX XXXXXXXX XX XXXXXXX XXXXXXX  XXXXXXXXXXXXXXXXXXXXXXXXXXX XX XXXX X
X                         XXXX XX                                                          XX XXXX X
X   X XXX XXX   XXXXXX XX         XXXXXXXX XXXXXXX X   XXXXXX  XXXXXXX XXXXXXXXXXXXXXX XX          X
X  XX XXX XXXX XXXXXXX XX XXXX XX XXXXXXXX XXXXXXX XX XXXXXXXX XXXXXXX XXXXXXXXXXXXXXX XXX XXXXXXX X
X XXX XXX XXXX XXXXXXX XX XXXX XX XXXXXXXX XXXXXXX XX XXXXXXXX XXXXXXX XXXXXXXXXXXXXXX XX  XXXXXXX X
X         XXXX XXXXXXX         XX                                                          XXXXXXX X
X XXX XXX XXXX XXXXXXX XX XXXX XX XXX   XXXXX   XX XXXXXXXXXXX XXXXXXX XXXXXXXXXXXXXXX XX          X
X XXX XXX XXXX XXXXXXX XX XXXX XX XXX  XXXXXXX XXX XXXXXXXXXXX XXXXXXX XXXXXXXXXXXXXXX XXX XXXXXXX X
X XXX XXX XXXX XXXXXXX XX XXXX XX XXX XXXXXXXX XXX XXXXXXXXXXX XXXXXXX XXXXXXXXXXXXXXX XXX XXXXXXX X
X XXX XXX XXXX XXXXXXX XX XXXX XX XXX XXXXXXXX XXX XXXXXXXXXXX XXXXXXX XXXXXXXXXXXXXXX XXX XXXXXXX X
X XXX XXX XXXX XXXXXXX XX XXXX XX XXX XXXXXXXX                 XXXXXXX XXXXXXXXXXXXXXX XXX XXXXXXX X
X XXX XXX XXXX XXXXXXX XX XXXX XX XXX XXXXXXXX XXX XXXXXXXXXXX XXXXXXX XXXXXXXXXXXXXXX XXX XXXXXXX X
X XXX XXX XXXX XXXXXXX XX XXXX XX XXX XXXXXXXX XXX XXXXXXXXXXX XXXXXXX XXXXXXXXXXXXXXX XXX XXXXXXX X
X XXX XX   XXX XXXXXX  XX XXXX XX XXX XXXXXXX   X  XXXXXXXXXXX XXXXXXX XXXXXXXXXXXXXXX XXX XXXXXXX X
X                                                                                                  X
X XXXX XXXXXXXXXX XXX  XX XXXX XX XXX XXX XXXX XX  XXXXXX XXXX XXXXXXXXXXXXXXXXXXX XXX XXXXXX XXX XX
X XXXX XXXXXXXXXX XXXX XX XXXX XX XXX XXX XXXX XXX XXXXXX XXXX XXXXXXXXXXXXXXXXXXX XXX XXXXXX XXX XX
X XXXX XXXXXXXXXX  XXX XX XXXX XX XXX XX   XXX XXX XXXXXX XXXX XXXXXXXXXXXXXXXXXXX XXX XXXXXX XXX XX
X XXXX XXXXXXXXXX      XX                                      XXXXXXXXXXXXXXXXXXX XXX XXXXXX      X
X XXXX XXXXXXXXXX  XXX XX XXXXXXXXXXXXXXXXXXXX XXX XXXXXX XXXX XXXXXXXXXXXXXXXXXXX XXX XXXXXX XXX XX
X XXXX XXXXXXXXXX XXX  XX  XXXXXXXXXXXXXXXXXXX XXX XXXXXX XXXX XXXXXXXXXXXXXXXXXXX XXX XXXXXX XXX XX
X XXXX XXXXXXXXXX      XX                          XXXXXX XXXX XXXXXXXXXXXXXXXXXXX XX  XXXXXX XXX XX
X XXXX XXXXXXXXXX XXX  XX  XXXXX   XXXXX   XX XXXX                                            XXX XX
X XXXX XXXXXXXXXX XXXX XX XXXXXXX XXXXXXX XXX XXXX XXXXXXXXXXX XXXXXXXXXXXXXXX XXX XX  XXXXXX XXX XX
X XXXX XXXXXXXXXX XXXX XX XXXXXXX XXXXXXX XXX XXXX XXXXXXXXXXX XXXXXXXXXXXXXXX XX  XXX XXXXXX XXX XX
X  XXX XXXXXXXXXX XXXT XX XXXXXXX XXXXXXX XXX XXXX XXXXXXXXXXX XXXXXXXXXXXXXXX X   XX   XXXXX XXX  X
X                      XX XXXXXXX XXXXXXX XXX XXXX                                                 X
X XXXX XXX XXXXXX XXX  XX XXXXXXX XXXXXXX XXX XXXX XXXXXX XXXX XX XXX XXXX XXX XXX XXX XXXXXX XXX  X
X XXXX XXX XXXXXX XXXX XX XXXXXXX XXXXXXX XXX XXXX XXXXXX XXXX XX XXX XXX  XXX XXX XXX XXXXXX XXX XX
X  XXX XX   XXXXX  XXX XX XXXXXXX XXXXXXX XXX XXXX XXXXXX XXX      XX XX   XXX XXX XXX XXXXXX XXX XX
X                      XX XXXXXXX XXXXXXX XXX XXXX XXXXXX                  XXX                XXX XX
X XXXX XXXXXXXXXX  XXX XX XXXXXXX XXXXXXX XXX XXXX XXXXXX XXXXXXXXXXX XXXX XXX XXX XXX XXXXXX XXX XX
X XXXX XXXXXXXXXX XXXX XX XXXXXXX XXXXXXX XXX XXXX XXXXXX XXXXXXXXXXX XXXX XXX XXX XXX XXXXXX XXX XX
X XXXX XXXXXXXXXX XXXX XX XXXXXXX XXXXXX   XX XXXX XXXXXX XXXXXXXXXXX XXXX XXX XXX XXX XXXXXX XXX XX
X                                                                                             XXX XX
X XXXXXXXX XXXXXX XXXX XX XXX XXXXXXXX XXXXXX XXXX XX XXX XXXXXXXXXXXXXXXX XXXXXX XXX XXXXXXX XXX XX
X XXXXXXXX XXXXXX XXXX XX XXX XXXXXXXX XXXXXX XXXX XX XXX XXXXXXXXXXXXXXXX XXXXXX XXX XXXXXXX XXX XX
X XXXXXXXX XXXXX   XXX XX  XX                 XXXX XX XXX XXXXXXXXXXXXXXXX XXXXXX             XXX XX
X                      XX     XXXXXXXX XXXXXX XXXX XX XXX XXXXXXXXXXXXXXXX XXXXXX XXX XXXXXXX      X
X XXXXXXXX XXX XXXXXXX XX  XX XXXXXXXX XXXXXX XXXX XX XXX XXXXXXXXXXXXXXXX XXXXXX XXX XXXXXXX XXX XX
X XXXXXXX  XXX XXXXXXX XX XXX XXXXXXXX XXXXXX XXXX XX XXX  XXXXXXXXXXXXXXX XXXXXX XXX XXXXXXX XXX XX
X          XXX XXXXXXX XX XXX XXXXXXXX XXXXXX XXXX XX XXX                                     XXX XX
X XXXXXXX              XX                     XXXX XX XXX  XXXXXXXXXXXXXXX XXXXXX XXXXXXXXXXX XXX XX
X XXXXXXXX XXX XXXXXXX XX XXX XXXXXXXXXXXXXXX XXXX XX XXX XXXXXXXXXXXXXXXX XXXXXX XXXXXXXXXXX XXX XX
X  XXXXXXX XXX XXXXXXX XX  XX XXXXXXXXXXXXXXX XXXX XX XXX XXXXXXXXXXXXXXX  XXXXXX XXXXXXXXXXX  XX XX
X                      XX   X XXXXXXXXXXXXXX   XXX X   XX XXXXXXXXXXXXXX   XXXXXX XXXXXXXXXXX   X XX
X  X   XXXXX   XXXXXXX XX                                                                          X
X XXX  XXXXXX XXXXXXXX XX XXXXXXXXXXXX XXXXXX XXXX XXX XX XXXXXXX XXXXXXXXXXXXXXXXXXXXXXXX XXXXXX XX
X  XXX XXXXXX XXXXXXXX XX XXXXXXXXXXXX XXXXXX XXXX XXX XX XXXXXXX XXXXXXXXXXXXXXXXXXXXXXXX XXXXXX XX
X   X   XXXXX XXXXXXXX XX XXXXXXXXXXX   XXXXX XXXX XXX XX XXXXXX   XXXXXXXXXXXXXXXXXXXXXX   XXXXX XX
X                                                                                                  X
X XXXXXXXXXXXXXXX XXXX XX XXXXXXXXXXXX XXXXXX XXXX XXX XX XXXX XX XXXXXXXXXXXXXXXX XXXXXXXXXXX XX XX
X XXXXXXXXXXXXXXX XXXX XX XXXXXXXXXXXX XXXXXX XXXX XXX XX XXXX XX XXXXXXXXXXXXXXXX XXXXXXXXXXX XX XX
X                      XX                          XXX XX XXXX XX XXXXXXXXXXXXXXXX XXXXXXXXXXX XX XX
X XXXXXX   XXXXXX XXXX XX XXXXXXXX XXX XXXXXXXXXXX XXX XX XXXX                     XXXXXXXXXXX XX XX
X XXXXXXX XXXXXXX XXXX XX XXXXXXXX XXX XXXXXXXXXXX XXX XX XXXX XX XXXXXXXXXXXXXXXX XXXXXXXXXXX XX XX
X XXXXXXX XXXXXXX XXXX XX XXXXXXXX XXX XXXXXXXXXXX XXX XX XXXX XX XXXXXXXXXXXXXXX  XXXXXXXXXXX XX XX
X XXXXXXX XXXXXXX XXXX XX              XXXXXXXXXXX XXX XX XXXX XX XXXXXXXXXXXXXX    XXXXXXXXX      X
X XXXXXXX XXXXXXX XXXX XX XXXXXXXX XXXdXXXXXXXXXXX                                                 X
XXXXXXXXXXXXXXXXXXXXXXXXXXXXXXXXXXXXXXXXXXXXXXXXXXXXXXXXXXXXXXXXXXXXXXXXXXXXXXXXXXXXXXXXXXXXXXXXXXXX
