XXXXXXXXXXXXXXXXXXXXXXXXXXXXXXXXXXXXXXXXXXXXXXXXXXXXXXXXXXXXXXXXXXXXXXXXXXXXXXXXXXXXXXXXXXXXXXXXXXXX
XAXXX3  XXXX   X   XXXXXX   XX1XXXXXXXXXXX XXXXXX XXXXXXXXXXXXXXXXBXX XXXXXXXXXXX XXXXXXXXXXXXXXX2XX
X                                                 XXXXXXXXXXXXXXXX XX XXXXXXXXXXX XXXXXXXXXXXXXXX XX
X XXX XXXX XXXXXXXXXXXXXXXXXXX XXXXXX XXXX XXXXXX XXXXXXXXXXXXXXXX XX XXXXXXXXXXX XXXXXXXXXXXXXXX XX
X XXX XXXX XXXXXXXXXXXXXXXXXXX XXXXXX XXXX XXXXXX XXXXXXXXXXXXXXXX XX XXXXXXXXXXX XXXXXXXXXXXXXXX XX
X XXX XXXX XXXXXXXXXXXXXXXXXXX XXXXXX XXXX XXXXXX XXXXXXXXXXXXXXXX XX XXXXXXXXXXX XXXXXXXXXXXXXXX XX
X XXX                          XXXXXX XXXX XXXXXX XXXXXXXXXXXXXXXX XX XXXXXXXXXXX                  X
X XXX XXXX XXXXXXXXXXXXXXXXXXX XXXXXX XXXX XXXXXX XXXXXXXXXXXXXXXX XX XXXXXXXXXXX XXXX XXXXXXXXXX XX
X XXX XXXX XXXXXXXXXXXXXXXXXXX XXXXXX XXXX XXXXXX XXXXXXXXXXXXXXXX XX XXXXXXXXXXX XXXX XXXXXXXXXX XX
X XXX XXXX XXXXXXXXXXXXXXXXXXX XXXXXX XXXX XXXXXX XXXXXXXXXXXXXXXX XX XXXXXXXXXXX XXXX XXXXXXXXXX XX
X XXX XXXX XXXXXXXXXXXXXXXXXXX XXXXXX XXXX XXXXXX XXXXXXXXXXXXXXXX XX XXXXXXXXXXX                 XX
X XXX XXXX XXXXXXXXXXXXXXXXXXX XXXXXX XXXX XXXXXX XXXXXXXXXXXXXXXX XX XXXXXXXXXXX XXXX XXXXXXXXXX XX
X XXX XXXX XXXXXXXXXXXXXXXXXXX XXXXXX XXXX XXXXXX XXXXXXXXXXXXXXXX XX XXXXXXXXXXX XXXX XXXXXXXXXX XX
X                              XXXXXX XXXX XXXXXX XXXXXXXXXXXXXXXX XX XXXXXXXXXXX XXXX XXXXXXXXXX XX
X XXX XXXXXXXXXX   XXX XXXXX               XXXXXX XXXXXXXXXXXXXXXX XX XXXXXXXXXXX XXXX XXXXXXXXXX XX
X XXX XXXXXXXXXXX XXXX XXXXXX  XXXXXX XXXX XXXXXX XXXXXXXXXXXXXXXX XX XXXXXXXXXXX XXXX XXXXXXXXXX XX
X XXX XXXXXXXXXXX XXXX XXXXXXX XXXXXX XXXX XXXXXX XXXXXXXXXXXXXXXX XX XXXXXXXXXXX XXXX XXXXXXXXXX XX
X XXX XXXXXXXXXXX XXXX XXXXXXX XXXXXX XXXX XXXXXX                                                  X
X                              XXXXXX XXXX XXXXXX XXXX XXXXXX XXXX XX XXXXXXX XXX XXXXXXXXXXX XXX  X
X XXX XXXXXXXXXXX XXXX XXXXXXX XXXXXX XXXX XXXXXX XXXX XXXXXX XXXX XX XXXXXXX XXX XXXXXXXXXXX XXXX X
X XXX XXXXXXXXXXX XXXX XXXXXX  XXXXXX XXXX XXXXXX XXXX XXXXXX XXXX XX XXXXXXX XXX XXXXXXXXXXX XXXX X
X XXX XXXXXXXXXXX              XXXXXX  XXX XXXXXX XXXX XXXXXX XXXX XX XXXXXXX XXX XXXXXXXXXXX XXXX X
X     XXXXXXXXXXX XXXXXXXXXXX  XXXXXX             XXXX             XX XXXXXXX XXX                  X
X XXX XXXXXXXXXXX XXXXXXXXXXXX XXXXXX  XXX XXXXXX XXXX XXXXXX XXXX XX XXXXXXX XXX XXXXXXXXXXX XXXXXX
X XXX XXXXXXXXXXX XXXXXXXXXXXX XXXXXX XXXX XXXXXX XXXX XXXXXX XXXX XX XXXXXXX XXX XXXXXXXXXXX XXXXXX
X XXX XXXXXXXXXX   XXXXXXXXXXX XXXXXX XXXX XXXXX   XXX XXXXXX XXXX XX XXXXXXX XXX  XXXXXXXXXX XXXXXX
X                                                                                                  X
X XXXXXXXXXXXXXXXXXXXX XX XXXXXXX XXXXXXXXXXXXXXXXXXXX XXXXXXXXXX XXXXXXXXXXX XXXX XXXXXX XXXXXXXXXX
X XXXXXXXXXXXXXXXXXXXX XX XXXXXXX XXXXXXXXXXXXXXXXXXXX XXXXXXXXXX XXXXXXXXXXX XXXX XXXXXX XXXXXXXXXX
X XXXXXXXXXXXXXXXXXXXX XX XXXXXXX XXXXXXXXXXXXXXXXXXXX XXXXXXXXXX XXXXXXXXXXX XXXX XXXXX   XXXXXXXXX
X                                                                                                  X
X XXXXXXXXXXXXXXXXXXXX XX XXXX XX XXXXXXXXXXXXXXXXXXXXXXXXXXXXXXX XXXXXXXXXXXXXXXXXXXXXXXX XXXXXXXXX
X XXXXXXXXXXXXXXXXXXXX XX XXXX XX XXXXXXXXXXXXXXXXXXXXXXXXXXXXXXX XXXXXXXXXXXXXXXXXXXXXXXX XXXXXXXXX
X XXXXXXXXXXXXXXXXXXXX XX XXXX                                                             XXXXXXXXX
X XXXXXXXXXXXXXXXXXXXX XX XXXX XX XXXXXXXXXXXXXXXXXXXXXXXXXXXXXXXXXXXXXXXXXXXXXXXXXXXXXXXX XXXXXXXXX
X XXXXXXXXXXXXXXXXXXXX XX XXXX XX XXXXXXXXXXXXXXXXXXXXXXXXXXXXXXXXXXXXXXXXXXXXXXXXXXXXXXXX XXXXXXXXX
X XXXXXXXXXXXXXXXXXXXX XX XXXX XX XXXXXXXXXXXXXXXXXXXXXXXXXXXXXXXXXXXXXXXXXXXXXXXXXXXXXXXX XXXXXXXXX
X XXXXXXXXXXXXXXXXXXXX XX XXXX XX XXXXXXXXXXXXXXXXXXXXXXXXXXXXXXXXXXXXXXXXXXXXXXXXXXXXXXXX XXXXXXXXX
X XXXXXXXXXXXXXXXXXXXX XX XXXX XX                                                                  X
X XXXXXXXXXXXXXXXXXXXX XX XXXX XX XXXXXXXXXXXXXXXXXXX XXXXXXXX XXXXXXXXXXXXXXXXXXXXXXXXXXX XXXXXXX X
X XXXXXXXXXXXXXXXXXXXX XX XXXX XX XXXXXXXXXXXXXXXXXXX XXXXXXXX XXXXXXXXXXXXXXXXXXXXXXXXXXX XXXXXXX X
X                         XXXX XX                                                          XXXXXXX X
X   XXXXXXXXXXXXXXXXXX XX         XXXXXXXXXXXXXXXX XX XXXXXXXX XXXXXXXXXXXXXXXXXXXXXXX XXX XXXXXXX X
X  XXXXXXXXXXXXXXXXXXX XX XXXX XX XXXXXXXXXXXXXXXX XX XXXXXXXX XXXXXXXXXXXXXXXXXXXXXXX XXX XXXXXXX X
X XXXXXXXXXXXXXXXXXXXX XX XXXX XX XXXXXXXXXXXXXXXX XX XXXXXXXX XXXXXXXXXXXXXXXXXXXXXXX XXX XXXXXXX X
X XXXXXXXXXXXXXXXXXXXX         XX                              XXXXXXXXXXXXXXXXXXXXXXX XXX XXXXXXX X
X XXXXXXXXXXXXXXXXXXXX XX XXXX XX XXXXXXXXXXXXXXXX XXXXXXXXXXX XXXXXXXXXXXXXXXXXXXXXXX XXX         X
X XXXXXXXXXXXXXXXXXXXX XX XXXX XX XXXXXXXXXXXXXXXX XXXXXXXXXXX XXXXXXXXXXXXXXXXXXXXXXX XXX XXXXXXX X
X XXXXXXXXXXXXXXXXXXXX XX XXXX XX XXXXXXXXXXXXXXXX XXXXXXXXXXX XXXXXXXXXXXXXXXXXXXXXXX XXX XXXXXXX X
X XXXXXXXXXXXXXXXXXXXX XX XXXX XX XXXXXXXXXXXXXXXX XXXXXXXXXXX XXXXXXXXXXXXXXXXXXXXXXX XXX XXXXXXX X
X XXXXXXXXXXXXXXXXXXXX XX XXXX XX XXXXXXXXXXXXXXXX XXXXXXXXXXX XXXXXXXXXXXXXXXXXXXXXXX XXX XXXXXXX X
X XXXXXXXXXXXXXXXXXXXX XX XXXX XX XXXXXXXXXXXXXXXX XXXXXXXXXXX XXXXXXXXXXXXXXXXXXXXXXX XXX XXXXXXX X
X XXXXXXXXXXXXXXXXXXXX XX XXXX XX XXXXXXXXXXXXXXXX XXXXXXXXXXX XXXXXXXXXXXXXXXXXXXXXXX XXX XXXXXXX X
X XXXXXXXXXXXXXXXXXXXX XX XXXX XX XXXXXXXXXXXXXXXX XXXXXXXXXXX XXXXXXXXXXXXXXXXXXXXXXX XXX XXXXXXX X
X                                                                                                  X
X XXXX XXXXXXXXXX XXXX XX XXXX XXXXXXXXXX XXXX XXX XXXXXXXXXXX XXXXXXXXXXXXXXXXXXX XXX XXXXXX XXX XX
X XXXX XXXXXXXXXX XXXX XX XXXX XXXXXXXXXX XXXX XXX XXXXXXXXXXX XXXXXXXXXXXXXXXXXXX XXX XXXXXX XXX XX
X XXXX XXXXXXXXXX XXXX XX XXXX XXXXXXXXX   XXX XXX XXXXXXXXXXX XXXXXXXXXXXXXXXXXXX XXX XXXXXX XXX XX
X XXXX XXXXXXXXXX XXXX XX                          XXXXXXXXXXX XXXXXXXXXXXXXXXXXXX XXX XXXXXX     DX
X XXXX XXXXXXXXXX XXXX XX XXXXXXXXXXXXXXXXXXXX XXX XXXXXXXXXXX XXXXXXXXXXXXXXXXXXX XXX XXXXXX XXX XX
X XXXX XXXXXXXXXX XXXX XX  XXXXXXXXXXXXXXXXXXX XXX XXXXXXXXXXX XXXXXXXXXXXXXXXXXXX XXX XXXXXX XXX XX
X XXXX XXXXXXXXXX XXXX XX                          XXXXXXXXXXX XXXXXXXXXXXXXXXXXXX XXX XXXXXX XXX XX
X XXXX XXXXXXXXXX XXXX XX  XXXXXXXXXXXXXXXXXX XXXX                                            XXX XX
X XXXX XXXXXXXXXX XXXX XX XXXXXXXXXXXXXXXXXXX XXXX XXXXXXXXXXX XXXXXXXXXXXXXXX XXX XXX XXXXXX XXX XX
X XXXX XXXXXXXXXX XXXX XX XXXXXXXXXXXXXXXXXXX XXXX XXXXXXXXXXX XXXXXXXXXXXXXXX XXX XXX XXXXXX XXX XX
X XXXX XXXXXXXXXX XXX  XX XXXXXXXXXXXXXXXXXXX XXXX XXXXXXXXXXX XXXXXXXXXXXXXXX XXX XX   XXXXX XXX XX
X                      XX XXXXXXXXXXXXXXXXXXX XXXX                                                 X
X XXXX XXXXXXXXXX XXX  XX XXXXXXXXXXXXXXXXXXX XXXX XXXXXX XXXXXXXXXXXXXXXX XXX XXXXXXXXXXXXXX XXX XX
X XXXX XXXXXXXXXX XXXX XX XXXXXXXXXXXXXXXXXXX XXXX XXXXXX XXXXXXXXXXXXXXXX XXX XXXXXXXXXXXXXX XXX XX
X  XXX XXXXXXXXXX XXXX XX XXXXXXXXXXXXXXXXXXX XXXX XXXXXX XXXXXXXXXXXXXXXX XXX XXXXXXXXXXXXXX XXX XX
X                      XX XXXXXXXXXXXXXXXXXXX XXXX XXXXXX XXXXXXXXXXXXXXXX XXX XXXXXXXXXXXXXX XXX XX
X XXXX XXXXXXXXXX XXXX XX XXXXXXXXXXXXXXXXXXX XXXX XXXXXX XXXXXXXXXXXXXXXX XXX XXXXXXXXXXXXXX XXX XX
X XXXX XXXXXXXXXX XXXX XX XXXXXXXXXXXXXXXXXXX XXXX XXXXXX XXXXXXXXXXXXXXXX XXX XXXXXXXXXXXXXX XXX XX
X XXXX XXXXXXXXXX XXXX XX XXXXXXXXXXXXXXXXXXX XXXX XXXXXX XXXXXXXXXXXXXXXX XXX XXXXXXXXXXXXXX XXX XX
X                                             T                                               XXX XX
X XXXXXXXX XXXXXX XXXX XX XXX XXXXXXXXXXXXXXX XXXX XXXXXX XXXXXXXXXXXXXXXX XXXXXX XXXXXXXXXXX XXX XX
X XXXXXXXX XXXXXX XXXX XX XXX XXXXXXXXXXXXXXX XXXX XXXXXX XXXXXXXXXXXXXXXX XXXXXX XXXXXXXXXXX XXX XX
X XXXXXXXX XXXXX   XXX XX XXX XXXXXXXXXXXXXXX XXXX XXXXXX XXXXXXXXXXXXXXXX XXXXXX XXXXXXXXXXX XXX XX
X                      XX XXX XXXXXXXXXXXXXXX XXXX XXXXXX XXXXXXXXXXXXXXXX XXXXXX XXXXXXXXXXX      X
X XXXXXXXX XXX XXXXXXX XX XXX XXXXXXXXXXXXXXX XXXX XXXXXX XXXXXXXXXXXXXXXX XXXXXX XXXXXXXXXXX XXX XX
X XXXXXXXX XXX XXXXXXX XX XXX XXXXXXXXXXXXXXX XXXX XXXXXX XXXXXXXXXXXXXXXX XXXXXX XXXXXXXXXXX XXX XX
X XXXXXXXX XXX XXXXXXX XX XXX XXXXXXXXXXXXXXX XXXX XXXXXX XXXXXXXXXXXXXXXX                    XXX XX
X XXXXXXXX             XX                     XXXX XXXXXX XXXXXXXXXXXXXXXX XXXXXX XXXXXXXXXXX XXX XX
X XXXXXXXX XXX XXXXXXX XX XXX XXXXXXXXXXXXXXX XXXX XXXXXX XXXXXXXXXXXXXXXX XXXXXX XXXXXXXXXXX XXX XX
X  XXXXXXX XXX XXXXXXX XX XXX XXXXXXXXXXXXXXX XXXX XXXXXX XXXXXXXXXXXXXXXX XXXXXX XXXXXXXXXXX  XX XX
X                      XX XXX XXXXXXXXXXXXXXX XXXX XXXXXX XXXXXXXXXXXXXXXX XXXXXX XXXXXXXXXXX   X XX
X  XXX XXXXXXXXXXXXXXX XX                                                                          X
X XXXX XXXXXXXXXXXXXXX XX XXXXXXXXXXXX XXXXXXXXXXX XXXXXXXXXXXXXXXXXXXXXXXXXXXXXXXXXXXXXXXXXXXXXX XX
X  XXX XXXXXXXXXXXXXXX XX XXXXXXXXXXXX XXXXXXXXXXX XXXXXXXXXXXXXXXXXXXXXXXXXXXXXXXXXXXXXXXXXXXXXX XX
X   X   XXXXXXXXXXXXXX XX XXXXXXXXXXX   XXXXXXXXXX XXXXXXXXXXXXXXXXXXXXXXXXXXXXXXXXXXXXXXXXXXXXXX XX
X                                                                                                  X
X XXXXXXXXXXXXXXX XXXX XX XXXXXXXXXXXX XXXXXXXXXXX XXXXXXXXXXX XXXXXXXXXXXXXXXXXXX XXXXXXXXXXX XX XX
X XXXXXXXXXXXXXXX XXXX XX XXXXXXXXXXXX XXXXXXXXXXX XXXXXXXXXXX XXXXXXXXXXXXXXXXXXX XXXXXXXXXXX XX XX
X                      XX                          XXXXXXXXXXX XXXXXXXXXXXXXXXXXXX XXXXXXXXXXX XX XX
X XXXXXXXXXXXXXXX XXXX XX XXXXXXXXXXXX XXXXXXXXXXX XXXXXXXXXXX XXXXXXXXXXXXXXXXXXX XXXXXXXXXXX XX XX
X XXXXXXXXXXXXXXX XXXX XX XXXXXXXXXXXX XXXXXXXXXXX XXXXXXXXXXX XXXXXXXXXXXXXXXXXXX XXXXXXXXXXX XX XX
X XXXXXXXXXXXXXXX XXXX XX XXXXXXXXXXXX XXXXXXXXXXX XXXXXXXXXXX XXXXXXXXXXXXXXXXXXX XXXXXXXXXXX XX XX
X XXXXXXXXXXXXXXX XXXX XX XXXXXXXXXXXX XXXXXXXXXXX XXXXXXXXXXX XXXXXXXXXXXXXXXXXX   XXXXXXXXX      X
X XXXXXXXXXXXXXXX XXXX XXCXXXXXXXXXXXX4XXXXXXXXXXX                                                 X
XXXXXXXXXXXXXXXXXXXXXXXXXXXXXXXXXXXXXXXXXXXXXXXXXXXXXXXXXXXXXXXXXXXXXXXXXXXXXXXXXXXXXXXXXXXXXXXXXXXX
