XXXXXXXXXXXXXXXXXXXX
X      XX  XXX XXXXX
X  XX      XXX XXXXX
X XXXX XX  XXX XXXXX
X XXXX XXX XXX XXXXX
X XXX   XX XXX XXXXX
X                  X
X XXXXXXXX XXX XXXXX
X XXXXXXXX XXX XXXXX
X                  X
X XXX XXXX XXX XXX X
X XXX XXXX XXX XXX X
X XXX XXX  XXX XXX X
X          XXX XXX X
X XXX XXX          X
X XXX XXXX XXX XXX X
X XXX XXXX XXXTXXX X
X                  X
X  XXXXXXX XX   XXXX
XXXXXXXXXXXXXXXXXXXX