XXXXXXXXXXXXXXXXXXXX
X XXXXXXX  XX XXXXXX
X                  X
X XXXXXXX  XX XXXXXX
X XXXXXXX XXX XXXXXX
X XXXXXXX XXX XXXXXX
X                  X
XX XXX XX XXX XXX XX
XX XX  XX XXX XXX XX
X          XX XX   X
XX XX  XX          X
XX XXX XX XXX XXXX X
XXTXXX XX XXX XXXX X
X             XXXX X
XX XXX XX XXX XXXX X
XX XXX XX XXX XXXX X
XX XXX XX XXX XXXX X
XX XXX XX XXX XXXX X
XX XXX             X
XXXXXXXXXXXXXXXXXXXX