XXXXXXXXXXXXXXXXXXXX
X A             b DX
XXXXXX XX XXX XXXXXX
XXXXXX XX XXX XXXXXX
XXXXXX XX XXX XXXXXX
X         d      C X
XXXX   XX XX   X   X
XXXXX  XX XXX XXX XX
XXXXXX XX XXX XXX XX
XXXXXX XX          X
X       eBXXX XX c X
XXXXXX XX XXX XXX XX
XXXXXX XX XXX XXX XX
XXXXXX XX       T  X
X         XXX XXX XX
XXXXXX XX XXX XXX XX
XXXXXX XX XXX XXX XX
XXXXXX XX XXX XXX XX
X     a   XXX    E X
XXXXXXXXXXXXXXXXXXXX