XXXXXXXXXXXXXXXXXXXX
X    B             X
X XXXX XT  XXX XX  X
X XXXX XX XXXX XXX X
X CXXX XX XXXX XXX X
X   XX XX XXXX XXX X
X                  X
X XXXX XXXXXXX XX XX
X XXX  XXXXXXX XX XX
X  X   XXXXXX  XX XX
Xc             XX XX
XdXXXXXXXXXXX  XX XX
X XXXXXXXXXXXX XX XX
X XXXXXXXXXXXX a   X
X         eE b XX XX
X XXXXXXXXXXXX XXDXX
X XXXXXXXXXXXX XX  X
X XXXXXXXXXXXX XX  X
X         A        X
XXXXXXXXXXXXXXXXXXXX