XXXXXXXXXXXXXXXXXXXX
X XXX    a c   XXX X
X XXX  X  TXX      X
X XXX XXX XXXX XXX X
X XXX XXX XXXX XXX X
X XXX              X
X XXX XXXXXXXX XX  X
X XXX XXXXXXXX XXX X
X XXX XXXXXXXXEXXX X
X XXX XXXXXXXX XXX X
X XXX              X
X XXX XXXXXXXXXXXX X
X XXX XXXXXXXXXXXX X
XD  B              X
X XXX   XXXXX XXXXbX
X XXX  XXXXXX XXXXCX
X XXXdXXXXXXX XXXX X
X XXX XXXXXX   XXX X
X   A  e           X
XXXXXXXXXXXXXXXXXXXX