XXXXXXXXXXXXXXXXXXXX
X              XX XX
X  XXXXXX XXX      X
X XXXXXXX XXXX XX XX
X XXXXXXX XXXX XX XX
X                 XX
X XXXXXXX XXXX X   X
X XXXXXXX XXXX XXTXX
X XXXXXXX XXXX XX XX
X              XX XX
X XXX   X XXXX XX XX
X XXXX XX XXXX XX XX
X  XXX XX XXXX XX XX
X      XX  XXX XX XX
X  XXX XX      XX XX
X XXXX XX  XXX XX XX
X XXX  XX XXXX XX XX
X XX   XX XXXX XX XX
X                  X
XXXXXXXXXXXXXXXXXXXX