XXXXXXXXXXXXXXXXXXXX
X XXXXXXXX XXX XXXXX
X XXXXXXXX XXX XXXXX
X XXXXXXXX XXX XXXXX
X XXXXXXXXAXXX XXXXX
X XXXXXXX          X
X          XXX XX XX
X XXXX XX  XXX XX XX
X XXXX XXX XXX XX XX
X  XXX XXX XXX XXBXX
X          XXX XX XX
X  XXX XXX XXX XX XX
X XXXX XXX XXX XX XX
X          XXX X   X
X XXXXXX          bX
X XXXXXXX  XXX XXXXX
X XXXXXXXX XXX XXXXX
X XXXXXXXX XX  XXXXX
X   T a            X
XXXXXXXXXXXXXXXXXXXX