XXXXXXXXXXXXXXXXXXXX
XA     XXX X   XX XX
X                  X
XXXXXX XXX XX  XX XX
XXXXXX XXX XX XXX XX
X                  X
X  Xb  XXX X   XX  X
X  XXa XXX XX XXX  X
XX XXX XXX XX XXX XX
X   X   X  XX XXX XX
X          XX XXX XX
XX XXX XX  XX XXX XX
XX XXX XX  XX XXX  X
X                  X
XX X    X  XX XXX  X
XX XX  XXX XX XXX XX
X  XX  XX  XX XXX  X
X          XX XX   X
XB XXTXXX          X
XXXXXXXXXXXXXXXXXXXX
