XXXXXXXXXXXXXXXXXXXX
XXXXXX XX  XXXXXXX X
X                  X
X XXXX XX  XXXXXXX X
X XXXX XXX XXXXXXX X
X      XXXB   A    X
X XXXX XXX XXXXXXX X
X XXXX XXX XXXXXXX X
X XXXX XXX XXXXXXX X
X XXX TXXXbXXXXXXX X
X      XXX         X
XXXXX  XXX XXX XXX X
XXXXXX XXX XXX XXX X
XXXXXX XXX XXX XXX X
X                  X
XXXXXX XXX XXX XXXXX
XXXXXX XXX XXX XXXXX
X            a     X
XXXXXX XXX XX   XXXX
XXXXXXXXXXXXXXXXXXXX