XXXXXXXXXXXXXXXXXXXX
X2  XXXXXX X   XX XX
X                  X
XXXXXX XXX XX XXX XX
XXXXXX XXX XX XXX XX
X                 XX
X  XXX XXX XX XXX XX
X  XXX XXX XX XXX XX
XX XXX XXX XX XXX XX
X   X   XT XX XXX XX
X          XX XXX XX
XX XXXXXX  XX XXX XX
XX XXXXXX  XX XXX XX
X          XX XXX XX
XX XX   X  XX XXX XX
XX XXX XXX XX XXX XX
X  XX  XX  XX XXX XX
X          XX XXX XX
XAXXX XXX        1BX
XXXXXXXXXXXXXXXXXXXX
