XXXXXXXXXXXXXXXXXXXXXXXXXXXXXXXXXXXXXXXXXXXXXXXXXXXXXXXXXXXX
X                                  T       XXXXXXXXXXXXXXX X
XXXXXX XXXXXXXXXXXXXXXXXXX XX   XX XXX XXX XXXXXXXXXXXXXXX X
XXXXXX XXXXXXXXXXXXXXXXXXX XXX XXX XXX XXX XXXXXXXXXXXXXXX X
XXXXXX XXXXXXXXXXXXXXXXXXX XXX XXX XXX XXX XXXXXXXXXXXXXXX X
X                                          XXXXXXXXXXXXXXX X
XXXXXX X   XXXXXXXXXXXXXX  XX   XXXXXXXXXX XXXXXXXXXXXXXXX X
XXXXXX XX XXXXXXXXXXXXXXX XXXX XXXXXXXXXXX XXXXXXXXXXXXXXX X
XXXXXX XX XXXXXXXXXXXXXXX XXXX XXXXXXXXXXX XXXXXXXXXXXXXXX X
XXXXXX XX XXXXXXXXXXXXXXX XXXX XXXXXXXXXXX XXXXXXXXXXXXXXX X
XXXXXX                                     XXXXXXXXXXXXXXX X
XXXXXX XXXXXXXXXXXXXXXXXX XXXXXXXXXXX XXXX XXXXXXXXXXXXXXX X
XXXXXX XXXXXXXXXXXXXXXXXX XXXXXXXXXXX XXXX XXXXXXXXXXXXXXX X
XXXXXX XXXXXXXXXXXXXXXXXX XXXXXXXXXXX XXXX                 X
XXXXXX XXXXXXXXXXXXXXXXXX XXXXXXXXXXX XXXX XXXXXXXXXXXXXXX X
XXXXXX XXXXXXXXXXXXXXXXXX XXXXXXXXXXX XXXX XXXXXXXXXXXXXXX X
XXXXXX XXXXXXXXXXXXXXXXXX XXXXXXXXXXX XXXX XXXXXXXXXXXXXXX X
X                                                 C        X
XX XXX X   XX   XXXXX   XXXXXXXXXXXXX  XXX XXX XXXXXX XXX XX
XX XXX XX XXX  XXXXXXX XXXXXXXXXXXXXXX XXX XXX XXXXXX XXX XX
XX XXX XX XXX XXXXXXXX XXXXXXXXXXXXXXX XXX XXX XXXXXX XXX XX
X  XXX XX XXX                    G         XX  XXXXXX XXX XX
X  XXX XX      XXXXXXXXXXXXXX f XXXXXX XXXa               XX
X  XXX XX XXX XXXXXXXXXXXXXXXX XXXXXXX XXX XX  XXX XX XXX XX
XX XXX XX XXX  XXXXXXXXXXXXXXX XXXXXX  XXX XXX XXX XX XXX XX
XX XXX XX XXX   B                          XXX             X
XX XXX XX XXX  XXXXXXXXXXXXXXXXXXXXXX XXX      XX  XXXXXX XX
XX XXX XX XXX XXXXXXXXXXXXXXXXXXXXXXX XXXX XXX XX XXXXXXX XX
XX XXX XX XXX XXXXXXXXXXXXXXXXXXXXXXX XXX  XXX XX XXXXXXX XX
XX XXX XX XXX XXXXXXXXXXXXXXXXXXXXXXX      XXX XX XXXXXXX XX
XX        XXX XXXXXXXXXXXXXXXXXXXXXXX XXX  XXX            XX
XX XXX XX XXX XXXXXXXXXXXXXXXXXXXXXXX XXXX XXX XX XXXXXXX XX
XX XXX XX XXX  XXXXXXXXXXXXXXXXXXXXXX XXXX XXX XX XXXXXXX XX
XX XXX XXdXXX                             H    XX XXXXXXX XX
XX XXX XX XXX  XXXXXXXXXXX XXXXXXXXXX   XX XX             XX
XX XXX XX XXX XXXXXXXXXXXX XXXXXXXXXXX XXX XXX XXX XXXXXX XX
XX XXX XX XXX XXXXXXXXXXXX XXXXXXXXXXX XXX XXX XXX XXXXXX XX
XX        XXX XXXXXXXXXXXX XXXXXXXXXXX XXX         XXXXXX XX
XX XXX XX XXX XXXXXXXXXXXX XXXXXXXXXXX XXX XXX XXX XXXXXX XX
XX XXX XX XXX XXXXXXXXXXXX XXXXXXXXXXX XXX XXX XXX XXXXXX XX
XX XXX XX XXX XXXXXXXXXXXX XXXXXXXXXXX XXX XXX XXX XXXXXX XX
XX      e                                          c       X
XX XXXXXXXXXX XXXXXXX XXXX XXXXXXXXXXXXXXX XXX XXX XX XXXXXX
XX XXXXXXXXXX XXXXXXX XXXX XXXXXXXXXXXXXXX XXX XXX XX XXXXXX
XX XXXXXXXXXX XXXXXXX XXXX XXXXXXXXXXXXXXX XXX XXX XX XXXXXX
XX XXXXXXXXXX                                       A      X
XX             XXXXXX XXXXXXXXXXXXXXXXXXXX XXX X   XX XX   X
XX XXXXXXXXXX XXXXXXX XXXXXXXXXXXXXXXXXXXX XXX XX XXX XXX XX
XX XXXXXXXXXX XXXXXXX XXXXXXXXXXXXXXXXXXXX XXX XX XXX XXX XX
XX XXXXXXXXXX XXXXXXX XXXXXXXXXXXXXXXXXXXX XX  XX XXX      X
X                            b                 XX XXX XXX XX
XX XXXXXXXXXXXXXXXXXXXXXXXXXXXXXX XXXXXXXX XX  XX XXX XXX XX
XX XXXXXXXXXXXXXXXXXXXXXXXXXXXXXX XXXXXXXX XXX XX  XX XXX XX
XX hg                                   F  XXX XX     XXX XX
X   XXXXXXXXXXXXXXXXXXXXXXXXXXXXX XXXXXXXX         XX XXX XX
XX XXXXXXXXXXXXXXXXXXXXXXXXXXXXXX XXXXXXXX XXX XX XXX XXX XX
XX XXXXXXXXXXXXXXXXXXXXXXXXXXXXXX XXXXXXXX XXX XX XXX XXX XX
XX XXXXXXXXXXXXXXXXXXXXXXXXXXXXXX              XX XXX XXX XX
XX XXXXXXXXXXXXXXXXXXXXXXXXXXXXXX XXXXXXXX XXXDXXEXXX XXX XX
XXXXXXXXXXXXXXXXXXXXXXXXXXXXXXXXXXXXXXXXXXXXXXXXXXXXXXXXXXXX