XXXXXXXXXXXXXXXXXXXXXXXXXXXXXXXXXXXXXXXXXXXXXXXXXXXXXXXXXXXX
X         XXXX XXXXXXXXXXXXXXXXXXX         XX XXX XXXXXXXX X
X XXXXXXX XXXX XXXXXXXXXXXXXXXXXXX XXXXXX  XX XXX XXXXXXXX X
X XXXXXXX XXXX XXXXXXXXXXXXXXXXXXX XXXXXXX XX XXX XXXXXXXX X
X XXXXXXXAXXXX XXXXXXXXXXXXXXXXXXX XXXXXXX XX XXX XXXXXXXX X
X XXXXXXX XXXX XXXXXXXXXXXXXXXXXXX XXXXXXX X   XX XXXXXXXX X
X XXXXXXX                          XXXXXXX                 X
X XXXXXXX XXXX XXXXXXXXXX XXXXXXXX XXXXXXX XXXXXX XXXXXXXX X
X XXXXXXX XXXX XXXXXXXXXX XXXXXXXXcXXXXXXX XXXXXX  XXXXXXX X
X                                  XXXXXXX XXXXXX   b      X
X  XX XXX XXXXXXX XXXXXXX XXXXXXX          XXXXXX  XXXXXXX X
X XXX XXX XXXXXXX XXXXXXX XXXXXXXX XXXXXXX XXXXXX XXXXXXXX X
X XXX XXX XXXXXXX XXXXXXX XXXXXXXX XXXXXXX XXXXXX XXXXXXXX X
X XXX XXX XXXXXXX XXXXXXX XXXXXXXX XXXXXXX                 X
X XXX XXX XXXXXXX XXXXXXX XXXXXXXX XXXXXXX XXXXXXXXX   XXX X
X XXX XXX XXXXXXX XXXXXXX XXXXXXXX XXXXXXXdXXXXXXXXXX XXXX X
X XXX XXX XXXXXXX XXXXXXX XXXXXXXX XXXXXXX XXXXXXXXXX XXXX X
X XXX XXX XXXXXX   XXXXXX XXXXXXXX XXXXXXX XXXXXXXXXX XXXX X
X                                                    a     X
X XXX XXX XXX XXXXXXXXXXX XXX XXXX XX XXXX XXXXXXXXXX XXXX X
X XXX XXX XXX XXXXXXXXXXX XXX XXXX XX XXXX XXXXXXXXXX XXXX X
X  XX XXX XXX XXXXXXXXXXX XXX XXXXB        XXXXXXXXXX XXXX X
X                         XXX XXXX XX XXXX                 X
X  XXXXXX XXX XXXXXXXXXXX XXX XXXX XX XXXX XXXXXXXXXX XXXX X
X XXXXXXX XXX XXXXXXXXXXX XXX XXXX XX XXXX XXXXXXXXXX XXXX X
X                                  XX XXXX                 X
XXXXX   X XXXXXXXX XXXXXX XXX XXXX XX XXXX XXXXX   XXXXXXX X
XXXXXX XX XXXXXXXX XXXXXX XXX XXXX XX XXXX XXXXXX XXXXXXXX X
XXXXXX XX XXXXXXXX XXXXXX XXX XXXX XX XXXX XXXXXX XXXXXXXX X
XXXXXX XX XXXXXXX   XXXXX XXX XXXX XX XXXX XXXXXX XXXXXXXX X
X                             XXXX XX XXXX XXXXXX XXXXXXXX X
XXXXXXXXX XXXXXXXXXXXXXXXXXXX XXXX XX XXXX XXXXXX XXXXXXXX X
XXXXXXXXX XXXXXXXXXXXXXXXXXXX XXXX XX XXXX XXXXXX XXXXXXXX X
X              T                                           X
XX XXX X   XX XXXXXXXXXXXXXXXX XXX XXXXXXX XX XXXXXXXXXXXXXX
XX XXX XX XXX XXXXXXXXXXXXXXXX XXX XXXXXXX XX XXXXXXXXXXXXXX
XX XXX XX XXX XXXXXXXXXXXXXXXX XXX XXXXXXX XX XXXXXXXXXXXXXX
XX XXX XX XXX XXXXXXXXXXXXXXXX XXX XXXXXXX XX  XXXXXXXXXXXXX
XX        XXX XXXXXXXXXXXXXXXX XXX XXXXXXX XX              X
XX XXX XX XXX XXXXXXXXXXXXXXXX XXX XXXXXXX XX  XXXXXXXXXXXXX
XX XXX XX XXX XXXXXXXXXXXXXXXX XXX XXXXXXX XX XXXXXXXXXXXXXX
XX XXX XX XXX XXXXXXXXXXXXXXX   XX XXXXXXX XX XXXXXXXXXXXXXX
X         XXX                              XX XXXXXXXXXXXXXX
XX XXXXXX XXX XXXXXXX XXXXXXXXXXXX XXX XXX XX XXXXXXXXXXXXXX
XX XXXXXX XXX XXXXXXX XXXXXXXXXXXX XXX XXX XX XXXXXXXXXXXXXX
XX XXXXXX XXX XXXXXXX XXXXXXXXXXXX XXX XXX XX XXXXXXXXXXXXXX
XX XXXXXX XXX                      XXX XXX                 X
XX XXXXXX XXX XXXXXXX XXXXXXXXXXXX XXX XXX XX XXX XXXXXXXXXX
XX XXXXXX  XX  XXXXXX XXXXXXXXXXXX XXX XXX XX XXX XXXXXXXXXX
XX XXXXXX                          XXX XXX XX XXX XXXXXXXXXX
XX XXXXXX  XX  XX XXX   XXXXXX XXX XXX XXX XX              X
XX XXXXXX XXX XXX XXXX XXXXXXX XXX XXX XXX XX XXX XXXXXXXXXX
XX XXXXXX XXX XXX XXXX XXXXXXX XXX XXX XXX XX XXX  XXXXXXXXX
XX XXXXXX XXX XXX XXXX            e        XX XXX          X
XX XXXXXX XXX XXX XXXX XXXXXXX XXX XXX XXX XX XXX  XXXXXXXXX
XX XXXXXX XXX XXX XXXX XXXXXXX XXX XXX XXX XX XXX XXXXXXXXXX
XX XXXXXX XXX XXX XXXX XXXXXXX XXX XXX XXX XX XXX XXXXXXXXXX
X                    E                     XX XXX XXXXXXXXXX
XXXXXXXXXC  X XXX XXXXXXXXXX   X  DXXXXXXX XX XXX XXXXXXXXXX
XXXXXXXXXXXXXXXXXXXXXXXXXXXXXXXXXXXXXXXXXXXXXXXXXXXXXXXXXXXX