XXXXXXXXXXXXXXXXXXXXXXXXXXXXXXXXXXXXXXXXXXXXXXXXXXXXXXXXXXXX
X                   A                         XXXXXXX XXXXXX
XX XXXXXXXXXX XXX XXX XXXXXXX  XX XXX   XX XX XXXXXXX XXXXXX
XX XXXXXXXXXX XXX XXX XXXXXXX XXX XXXX XXX XX XXXXXXX XXXXXX
XX XXXXXXXXXX XXX XXX XXXXXXX XXX XXXX XXX XX XXXXXXX XXXXXX
XX XXXXXXXXXX                 XXX XXXX XXX XX        C     X
XX XXXXXXXXXX XXX XXXXXXXXXXX XXX XXXX          X XXX XXXXXX
XX XXXXXXXXXX XXX XXXXXXXXXXX XXX XXXX XXX XX  XX XXX XXXXXX
XX XXXXXXXXXX XXX XXXXXXXXXXX XXX XXXX XXX XX XXX XXX XXXXXX
XX XXXXXXXXXX XXX XXXXXXXXXXX XXX XXXX XXX XX XXX XXX  XXXXX
X                                      XXX XX XXX XXX      X
XX XXXXXXXXXX XXXXXXXXXXXXXXX XXXgXXXX XXX XX XXX XXX  XX XX
XX XXXXXXXXXX XXXXXXXXXXXXXXX  XX XXXX XXX XX XXX XXX XXX  X
XX XXXXXXXXXX XXXXXXXXXXXXXXX     XXXX XXX XX XXX XXX XXX  X
XX XXXXXXXXXX XXXXXXXXXXXXXXX  XX XXXX XXX XX XXX XXX XXX  X
XX XXXXXXXXXX XXXXXXXXXXXXXXX XXX XXXX XXX XX XXX XXXFXXX XX
XX XXXXXXXXXX XXXXXXXXXXXXXXX XXX XXXX XXX XX XXXBXXX XXX XX
XX XXXXXXXXXX                e    XXXX XXX XX         XXX XX
XX XXXXXXXXXX XXXXXXXXXXXXXXX XXX XXXX        XXX XXX XXX XX
XX XXXXXXXXXX XXXXXXXXXXXXXXX XXX XXXX XXX XX XXX XXX XXX XX
XX XXXXXXXXXX XXXXXXXXXXXXXXX XXX XXXX XXX XX XXX XXXHXXX XX
XX XXXXXXXXXX XXXXXXXXXXXXXXX XXX XXXX XXX XX XXX XXX   D  X
XX XXXXXXXXXX                     XXXX XXX XX XXXbXXX XXX XX
XX XXXXXXXXXX XXXXXXXXXXX XXXhXXX XXXX XXX XX XXX XXX XXX XX
XX XXXXXXXXXX XXXXXXXXXXX XXX XXX XXXX XXX XX XXX XXX XXX XX
X                                             T            X
XXXXXX XXX XX XXXXXXXXXXX  XXXXXXXXXXXXXXXXXX XXXX XX XX   X
XXXXXX XXX XX XXXXXXXXXXXX XXXXXXXXXXXXXXXXXX XXXX XX XXX XX
XXXXXX XXX XX XXXXXXXXXXXX XXXXXXXXXXXXXXXXXX XXXX XX XXX XX
XXXXXX        XXXXXXXXXXXX XXXXXXXXXXXXXXXXXX XXXX XX XXX XX
XXXXXX XXX XX                                 XXXX XX XXX XX
XXXXXX XXX XX XXXXXXXXXXXX XXXXXXXXXXXXXXXXXX XXXX XX XXX XX
XXXXXX XXX XX XXXXXXXXXXXX XXXXXXXXXXXXXXXXXX XXXX XX XXX XX
X                                            dXXX  XX XXX XX
X   XX XX XXX XXX XXXXXXXXXXXXXXXX XXX XXXXXX      XX XXX XX
XX XXX XX XXX XXX XXXXXXXXXXXXXXXX XXX XXXXXX XXX  XX XXX XX
XX XXX XX XXX XXX XXXXXXXXXXXXXXXX XXX XXXXXX XXXX XX XXX XX
XX XXX XX XXX XXX                             XXXX XX XXX XX
XX XXX XX XXX XXX XXX XXXXXXXXXXXX XXX XXX XX XXXX XX XXX XX
XX XXX XX XXX XXX XXX XXXXXXXXXXXX XXX XXX XX XXXX XX XXX XX
XX XXX XX XXX XXX XXX XXXXXXXXXXXX XXX XXX XX  XXX XX XXX XX
XX XXX XX XXX XXX XX   XXXXXXXXXXXGXX   XX XX      XX XXX XX
XX XXX XX XXX                            E     XXX XX XXX XX
XX XXX XX XXX XXX XXXX XXXXXXXXXXXXXX XXXX XX XXXX XX XXX XX
XX XXX XX XXX XXX XXXX XXXXXXXXXXXXXX XXXX XX XXXX XX XXX XX
XX XXX XX XXX XXX XXXX XXXXXXXXXXXXXX XXXX XXaXXXX XX XXX XX
XX XXX XX XXX XXX                     XXXX XX XXXX XX XXX XX
XX XXX XX XXX XXX XXXX XXXXXXXXXXXXXX XXXX XX XXXX XX XXX XX
XX XXX XX XXX XXX fXXX XXXXXXXXXXXXXX XXXX XX XXXX XX XXX XX
XX XXX XX XXX XXX                     XXXX XX XXXX XX XXX XX
XX XXX             XXXXXXXXXXXXXX XXX XXXX XX XXXX XX XXX XX
XX XXX XX XXX XXX XXXXXXXXXXXXXXX XXX XXXX XX XXXX XX XXX XX
XX XXX XX XXX  XX XXXXXXXXXXXXXXX XXX XXXX XX XXXX XX XXX XX
XX XXX XX XXX                              XX XXXX XX XXX XX
XX XXX         XX XX   XX XXXXXXX XXX XXXX XX XXXX XX XXX XX
XX XXX XX XXX XXX XXX XXX XXXXXXX XXX XXXX XX XXXX XX XXX XX
XX XXX XX XXX XXX XXX XXX XXXXXXX XXX XXXX XX XXXX XX XXX XX
X         XXX XXX XXX XXX XXXXXXX XXX XXXX X   XXX X   XX XX
XXXXXX X      XXX XXX                   c                  X
XXXXXXXXXXXXXXXXXXXXXXXXXXXXXXXXXXXXXXXXXXXXXXXXXXXXXXXXXXXX