XXXXXXXXXXXXXXXXXXXXXXXXXXXXXXXXXXXXXXXXXXXXXXXXXXXXXXXXXXXX
X  XXX XXXXXXX XXXXXXXXXXXXXXXXXXXXXXXXXXX XXXXXXXXXXXXXX XX
X  XXX XXXXXXX XXXXXXXXXXXXXXXXXXXXXXXXXXX                 X
XX XXX XXXXXXX XXXXXXXXXXXXXXXXXXXXXXXXXXX XXXXXXXXXXXXXX XX
XX XXX XXXXXXX XXXXXXXXXXXXXXXXXXXXXXXXXXX XXXXXXXXXXXXXX XX
XX XXX XXXXXXX XXXXXXXXXXXXXXXXXXXXXXXXXXX XXXXXXXXXXXXXX XX
XX XXX                                     XXXXXXXXXXXXXX XX
XX XXX XXXXXXX XXXXXXXXXXXXXXXXXX XXXXXXXX XXXXXXXXXXXXXX XX
XX XXX XXXXXXX XXXXXXXXXXXXXXXXXX XXXXXXXX XXXXXXXXXXXXXX XX
XX XXX XXXXXXX XXXXXXXXXXXXXXXXXX XXXXXXXX XXXXXXXXXXXXXX XX
XX XXX XXXXXXX                             XXXXXXXXXXXXXX XX
XX XXX XXXXXXX XXXXXXXXXXXXXXXXXX XXXXXXXX XXXXXXXXXXXXXX XX
XX XXX XXXXXXX XXXXXXXXXXXXXXXXXX XXXXXXXX XXXXXXXXXXXXXX XX
XX XXX                                                     X
X      XXX XXXXXXXXXXXXXXXXXXX XXXXXXXXXXX XXXXXX   XXXXXXXX
XX XXX XXX XXXXXXXXXXXXXXXXXXX XXXXXXXXXXX XXXXXXX XXXXXXXXX
XX XXX XXX XXXXXXXXXXXXXXXXXXX XXXXXXXXXXX XXXXXXX XXXXXXXXX
XX XXX XXX XXXXXXXXXXXXXXXXXX   XXXXXXXXXX XXXXXXX XXXXXXXXX
XX                                                         X
XX XXX XXX XXXXXX XXXXXXXXXXXXXXXX XXXXXXXXXXX XXXXXXXXXX XX
XX XXX XXX XXXXXX XXXXXXXXXXXXXXXX XXXXXXXXXXX XXXXXXXXXX XX
X      XXX XXXXX   XXXXXXXXXXXXXX   XXXXXXXXXX XXXXXXXXX   X
XX XXX                                                     X
XX XXX XXXXXXXXXXXXXX XXXXXXXXXXXXXXXXXXXXXXXX XXXXXXXXXX XX
XX XXX XXXXXXXXXXXXXX XXXXXXXXXXXXXXXXXXXXXXXX XXXXXXXXXX XX
X                                                          X
XX XXXXXXX XX XXXXXXX XXXXXXXXXXXX XX      XX   XX XX   X XX
XX XXXXXXX XX XXXXXXX XXXXXXXXXXXX XXX XX XXXX XXX XX  XX XX
XX XXXXXXX XX XXXXXXX XXXXXXXXXXXX XXX XX XXXX XXX XX XXX XX
XX                                   T                     X
XX XXXXXXX XX XXXXXXXXXXXXXXX XXXX XX XXXXXXXX XXX XX XXXX X
XX XXXXXXX XX XXXXXXXXXXXXXXX XXXX XX XXXXXXXX XXX XX XXXX X
XX XXXXXXX XX XXXXXXXXXXXXXXX XXXX XX XXXXXXXX XXX XX XXXX X
XX XXXXXXX XX XXXXXXXXXXXXXXX XXXX XX XXXXXXXX        XXXX X
XX XXXXXXX XX XXXXXXXXXXXXXXX XXXX             XXX XX XXXX X
XX XXXXXXX XX XXXXXXXXXXXXXXX XXXX XX XXXXXXXX XXX XX XXXX X
X  XXXXXXX XX XXXXXXXXXXXXXXX XXXX XX XXXXXXXX XXX XX XXXX X
X  XXXXXXX XX XXXXXXXXXXXXXXX XXXX XX XXXXXXXX XX  XX  XXX X
X  XXXXXXX XX XXXXXXXXXXXXXXX XXXX                         X
XX XXXXXXX XX XXXXXXXXXXXXXXX XXXX XX XXXXXXXXXXX XXXX XXX X
XX XXXXXXX XX XXXXXXXXXXXXXXX XXXX XX XXXXXXXXXXX XXXX XXX X
XX XXXXXXX XX                                              X
XX XXXXXXX XX XXXX XXXXXXXXXX XXXX XX XXX XXX   XXXXXX XXX X
XX XXXXXXX XX XXXX XXXXXXXXXX XXXX XX XXX XXXX XXXXXXX XXX X
XX XXXXXXX XX XXXX XXXXXXXXXX XXXX XX XXX XXXX XXXXXXX XXX X
X             XXX  XXXXXXXXXX XXXX XX XXX XXX              X
XX XXXXXXX XX      XXXXXXXXXX XXXX XX          XXXXXX XXXX X
XX XXXXXXX XX XXX  XXXXXXXXXX XXXX XX XXX XXXX XXXXXX XXXX X
XX XXXXXXX XX XXXX XXXXXXXXXX XXXX XX XXX XXXX XXXXXX XXXX X
X                                  XX XXX XXXX XXXXXX XXXX X
X  XXXXXXX XX XXXX XXXXXXX XXXXXXX XX XXX XXXX XXXXXX XXXX X
X  XXXXXXX XX XXXX XXXXXXX XXXXXXX XX XXX XXXX XXXXXX XXXX X
XX XXXXXXX XX XXXX XXXXXXX XXXXXXX XX XXX XXXX XXXXXX XXXX X
XX            XXXX XXXXXXX XXXXXXX XX XXX XXXX XXXXXX XXXX X
XX XXXXXXX XX XXXX                 XX XXX XXXX XXXXXX XXXX X
XX XXXXXXX XX XXXX XXXXXXX XXXXXXX XX XXX XXXX XXXXXX XXXX X
XX XXXXXXX XX XXXX XXXXXXX XXXXXXX XX  XX XXXX XXXXXX XXXX X
XX                                                         X
X   XXXXX   X XXXXXXXXXXXXXXXXXXXXXXXX XXXXXXXXXX   X XXX  X
XXXXXXXXXXXXXXXXXXXXXXXXXXXXXXXXXXXXXXXXXXXXXXXXXXXXXXXXXXXX