XXXXXXXXXXXXXXXXXXXXXXXXXXXXXXXXXXXXXXXXXXXXXXXXXXXXXXXXXXXX
X XXXX XX XXX XXXXXXXXXXX XXX XXXX XXXXXXX XX XXXX     XX XX
X XXXX XX XXX XXXXXXXXXXX XXX              XX XXXX XX  XX XX
X XXXX XX XXX XXXXXXXXXXX XXX XXXX XXXXXXX XX XXXX XXX XX XX
X XXXX XX XXX XXXXXXXXXXX XXX XXX  XXXXXXX XX XXXX XXX XX XX
X  XXX XX XXX XXXXXXXXXXX XXX      XXXXXX  XX XXXX XXX     X
X      XX XXX XXXXXXXXXXX XXX XXX          XX XXXX XXX XX XX
X  XXX XX XXX XXXXXXXXXXX XXX XXXX XXXXXX  XX XXXX XXX XX XX
X XXXX XX XXX XXXXXXXXXXX XXX XXXX XXXXXXX XX XXXX XXX XX XX
XTXXXX XX XXX XXXXXXXXXXXcXXX XXXX XXXXXXX XX XXXX XXX XX XX
X XXXX XX XXX XXXXXXXXXXX XXX XXXX XXXXXXX XX          XX XX
X XXXX XX XXX XXXXXXXXXXX XXX XXXX XXXXXXX XX XXXX XXX XX XX
X XXXX XX XXX XXXXXXXXXXXeXXX XXXX XXXXXXX XX XXXXCXXX XX  X
X XXXX XX XXX XXXXXXXXXXX XXX XXXX XXXXXXX XX XXXX XXX XX  X
X XXXX XX XXX XXXXXXXXXXX XXX XXXX XXXXXXX XX XXXX XXX XX  X
X XXXX XX XXX XXXXXXXXXXX XXX XXXX XXXXXXX XX XXXX XXX XX XX
X XXXX XX XXX XXXXXXXXXXX XXX XXXX XXXXXXX XX XXXX XXX XX XX
X XXXX XX                  XX XXXX XXXXXXX XX XXXX XXX     X
X      XX XXX XXXXXXXXXXX                  XX XXXX XXX XX XX
X XXXX XX XXX XXXXXXXXXXX  XX XXXXXXXXXXXX XX XXXX XXX XX XX
X XXXX XX XXX XXXXXXXXXXX XXX XXXXXXXXXXXX XX XXXX XXX XX XX
X XXXX                    XXX                 XXXX XXX XX XX
X D    XX XXXXXXXXXXX   X XXX XXXXXXXXXXXX XX          XX XX
X XXXX XX XXXXXXXXXXX  XX XXX XXXXXXXXXXXX XX XXXX XXX XX XX
X XXXX XX XXXXXXXXXXX XXX XXX XXXXXXXXXXXX XX XXXX XX  XX XX
X XXXX XX                 XXX XXXXXXXXXXXX XX  a       XX XX
X XXXX XX XXXXXXXXXXX XXX XXX                 XX   XX  XX XX
X XXXX XX XXXXXXXXXXX XXX XXX XXXXXXXXXXXX XX XXX XXXX XXBXX
X XXXX XX XXXXXXXXXXX XXX XXX XXXXXXXXXXXX XX XXX XXXX XX XX
X XXXX XX XXXXXXXXXX   XX XXX XXXXXXXXXXXX XX XXX XXXX XX XX
X                         XXX XXXXXXXXXXXX                 X
X XXXX XXX XXXXXXXXXXXXXX XXX XXXXXXXXXXXX XX XXX XXXX XXX X
X XXXX XXX XXXXXXXXXXXXXX XXX XXXXXXXXXXXX XX XXX XXXX XXX X
X XXXX                    XXX XXXXXXXXXXXX XX XXX XXXX XXX X
X XXXX XXX XX XXX XXXX XX XXX XXXXXXXXXXXX XX          XXX X
X XXXX XXX XX XXX XXXX XX XXX XXXXXXXXXXXX XX XXX XXXX XXX X
X XXXX XXX XX XXX XXX  XX XXX XXXXXXXXXXXX XX XXX XXXX XXX X
X XXXX XXX XX XXX      XX  XXdXXXXXXXXXXXX XX  XX XXXX XXX X
X XXXX XXX XX XXX XXX  XX  E  XXXXXXXXXXXX XX     XXXX XXX X
X XXXX XXX XX XXX XXXX XX  XX XXXXXXXXXXXX XX  XX XXXX XXX X
X XXXX XXX XX XXX XXXX XX XXX XXXXXXXXXXX  XX XXX XXXX XXX X
X      XXX XX XXX XXX   X XXX              XX XXX XXXX XXX X
X XXXX XXX                XXX XXXXXXXXXXX  XX          XXX X
X XXXX XXX XX XXX XXXXXXX XXX XXXXXXXXXXXX XX XXX XXXX XXX X
X XXXX XXX XX XXX XXXXXXX XXX XXXXXXXXXXXX XX XXX  XXX XXX X
X XXXX XXX XX XXX XXXXXXX XXX XXXXXXXXXXXX XX XXX   XX XXX X
X XXXX XXX        XXXXXXX                              XXX X
X XXXX XXX XX XXX XXXXXXX XXX XXXXXXXXXXXX XX XXXXXXXX XXX X
X XXXX XXX XX XXX XXXXXXX XXX XXXXXXXXXXX  XX XXXXXXXX XXX X
X          XX XXX XXXXXXX XXX              XX XXXXXXXX XXX X
XXXXXX XXX XX XXX XXXXXXX XXX XXXXXXXXXXX  XX XXXXXXXX     X
XXXXXX XXX XX XXX XXXXXXX XXX XXXXXXXXXXXX XX XXXXXXXX XXX X
XXXXXX XXX XX XXX XXXXXXX XXX XXXXXXXXXXXX XX XXXXXXXX XXX X
XXXXXX XXX XX XXX XXXXXXX XX   XXXXXXXXXXX XX XXXXXXXXbXXX X
X                                                          X
XXXXXXXXXXXXXX XXXXXXX XX XXXXXXXXXXXX XXX XX XXXXXXXXXXXXXX
XXXXXXXXXXXXXX XXXXXXXAXX XXXXXXXXXXXX XXX XX XXXXXXXXXXXXXX
X                                             XXXXXXXXXXXXXX
XXXXXXXXXXXXXX X   XXX XXXXXXXXXXXXXXX XXXXXX XXXXXXXXXXXXXX
XXXXXXXXXXXXXXXXXXXXXXXXXXXXXXXXXXXXXXXXXXXXXXXXXXXXXXXXXXXX