XXXXXXXXXXXXXXXXXXXXXXXXXXXXXXXXXXXXXXXXXXXXXXXXXXXXXXXXXXXX
X     XXX                  XX XXXX XXXXXX  XX XXX  XXX XXXXX
X XXX XXX XXXXXXXXXXX XXXX XX XXXX XXXXXX          XXX XXXXX
X XXX XXX XXXXXXXXXXX XXXX XX XXXX XXXXXX  XX XXX  XXX XXXXX
X XXX XXX XXXXXXXXXXX XXXX XX XXX  XXXXXX XXX XXXX XXX XXXXX
X XXX XXX XXXXXXXXXXX XXXX XX      XXXXXX XXX XXXX XXX XXXXX
X         E                XX XXX  XXXXXX XXX XXXX XXX XXXXX
X XXX XXX XXXX XX XXX XXXX XX XXXX XXXXXX XXX XXXX XXX XXXXX
X XXX XXX XXXX XX XXX XXXX XX XXXX XXXXXX XXX XXXX XXX XXXXX
X XXX XXX XXXX XX XXX XXXX XX XXXX XXXXXX XXX XXXX       C X
X                 XXX XXXX XX XXXX XXXXXX XXX XXXX XXX XXXXX
X XXX XXX XXXX XX XXX XXXX XX XXXX XXXXXX XXX XXXX XXX XXXXX
X XXX XXX XXXX XX XXX XXXX XX XXXX XXXXXX XXX XXXX XXX XXXXX
X XXX          XX XXX         XXX  XXXXXX  XX XXX      XXXXX
X     XXX XXXX XX XXX XXXX XX      XXXXXX    B     XX      X
X XXX XXX XXXXeXX XXX XXXX XX XXXA XXXXXX  XX XXXX XXX XXXXX
X XXX XXX XXXX XX XXX XXXX XX XXXX XXXXXX XXX XXXX XXX XXXXX
X XXX XXX XXXX XX XXX XXXX XX XXXX XXXXXX XXX XXXX XXX XXXXX
X XXX XXX XXXX XX          XX             XXX XXXX XXX XXXXX
X XXX XXX XXXX XX XXX XXXX XX XXXX XXX XX XXX XXXX XXX XXXXX
X XXX XXX XXXX XX XXX XXXX XX XXXX XXX XX XXX XXXX XXX XXXXX
X     XXX XXXX XX XXX XXXX XX XXXX        XXX XXXX XXX XXXXX
X XXX XXX XXXX XX XXX XXXX XX XXXX XXX XX XXX XXXX XXX XXXXX
X XXX XXX XXXX XX XXX XXXX XX XXXX XXX XX XXX XXXX XXX XXXXX
X XXX XXX XXXX XX XXX XXXX XX XXXX XX  XX XXX XXXX XXX XXXXX
X XXX XXX XXXX XX XXX XXXX XX XXXX     XX XXX XXXX XX TXXXXX
X XXX XXX XXXX XX XXX XXXX XX XXXX XX  a      XXXX     XXXXX
X XXX XXX XXXX XX XXX XXXX XXbXXXX XXX XX XXX XXXX XX  XXXXX
X XXX XXX XXXX XX XXX XXXX XX XXXX XXX XX XXX XXXX XXX XXXXX
X XXX XXX XXXX XX XXX XXXX XX XXXX XXX XX                  X
X                          XX XXXX XXX XX XXX XXXX XX XXXXXX
XXXXXX XX XXX XXX XXX XXXX XX XXXX XXX XX XXX XXXX XX XXXXXX
XXXXXX XX XXX XXX XXX XXX  XX XXXX XXX XX XXX XXXX XX XXXXXX
XXXXXX XX  XX XXX XXX      XX XXXX XXX XX XXX XXXX         X
XXXXXX XX     XXX XXX XXX  XX             XXX XXXX XX XXXXXX
XXXXXX XX  XX XXX XXX XXXX XX XXXX XXXXXX XXX XXXX XX XXXXXX
XXXXXX XX XXX XXX XXX XXX  XX XXXX XXXXXX XXX XXXX XX  XXXXX
XXXXXX XX XXX  XX XXX  X   XX                              X
X         XXX     XXX      XX XX   X   XX XXXXXXXXXXXX XX  X
XXXXXX XX XXX  XX XXX  XXX XX XXX XXX XXX XXXXXXXXXXXX XXX X
XXXXXX XX XXX XXX XXX XXXX XX XXX XXX XXX XXXXXXXXXXXX XXX X
XXXXXX XX XXX XXX XXX XXXX XXDXXX XXX XXX XXXXXXXXXXXX XXX X
XXXXXX XX         XXX XXXX XX         XXX XXXXXXXXXXXX XXX X
XXXXXX XX XXX XXX XXX XXXX XX XXX XXX XXX XXXXXXXXXXXX XXX X
XXXXXX XX XXX XXX XXX XXXX XX XXX XXX XXX XXXXXXXXXXXX XXX X
XXXXXX XX XXX XXX XXX XXXX XX XXX XXX XXX XXXXXXXXXXXX XXX X
X         c                                                X
XXXXXXXXXXXXXXXXX XXXXXXXX XX XXX XXXX XXXXXXX XXXXXXXXXXXXX
XXXXXXXXXXXXXXXXX XXXXXXXX XX XXX XXXX XXXXXXX XXXXXXXXXXXXX
XXXXXXXXXXXXXXXXX XXXXXXXX XX XXX XXXX XXXXXXX XXXXXXXXXXXXX
XXXXXXXXXXXXXXXXX XXXXXXXX XX                              X
XXXXXXXXXXXXXXXXX XXXXXXXX XX XXX XXX  XXX XXX XXXXXXXXXXXXX
XXXXXXXXXXXXXXXXX XXXXXXXX XX XXX XXX XXXX XXX XXXXXXXXXXXXX
XXXXXXXXXXXXXXXXX XXXXXXXX    dXX XXX XXXX XXX XXXXXXXXXXXXX
X                          XX              XXX XXXXXXXXXXXXX
XXXXXXXXXXXXXX XX XXXXXXXX XX XXX XXX XXXX XXX XXXXXXXXXXXXX
XXXXXXXXXXXXXX XX XXXXXXXX XX XXX XXX XXXX XXX XXXXXXXXXXXXX
XXXXXXXXXXXXX   X XXXXXXX  XX                  XXXXXXXXXXXXX
X                          XX XXXXXXXXXXXX XXX XXXXXXXXXXXXX
XXXXXXXXXXXXXXXXXXXXXXXXXXXXXXXXXXXXXXXXXXXXXXXXXXXXXXXXXXXX