XXXXXXXXXXXXXXXXXXXXXXXXXXXXXXXXXXXXXXXXXXXXXXXXXXXXXXXXXXXX
XAXXXXXXXBXXXX XX2XXX              XXXXXX1XXXXXXXXXXX XXXXXX
X                 XXX  XXXXXXXXXXX XXXXXX XXXXXXXXXXX XXXXXX
X XXXXXXX XXXX XX XXX XXXXXXXXXXXX XXXXXX XXXXXXXXXXX XXXXXX
X XXXXXXX XXX  XX XXX XXXXXXXXXXX  XXXXXX XXXXXXXXXXX XXXXXX
X XXXXXXX      XX XXX              XXXXXX                  X
X XXXXXXX XXX  XX XXX XXXXXXX XXX  XXXXXX XXXXXX   XX XXX XX
X XXXXXXX XXXX XX XXX XXXXXXX XXXX XXXXXX XXXXXXX XXX XXX XX
X XXXXXXX XXXX XX XXX XXXXXXX  XXX XXXXXX XXXXXXX XXX XXX XX
X  XXXXXX XXXX XX XXX XXXXXXX      XXXXXX XXXXXXX XXX XXX XX
X                     XXXXXXX  XXX XXXXXX XXXXXXX XXX      X
XX XXXXXXXXXXX XX XXX XXXXXXX XXXX XXXXXX XXXXXXX XXX XXX XX
XX XXXXXXXXXXX XX XXX XXXXXXX XXXX XXXXXX XXXXXXX XXX XXX XX
XX XXXXXXXXXXX XX XXX XXXXXX   XXX XXXXXX  XXXXXX XXX XXX XX
XX XXXXXXXXXXX XX XXX                                 XXX XX
XX XXXXXXXXXXX XX XXX XXXXXXXXXXXX XXXXXX  XX XXXXXXX XXX XX
XX XXXXXXXXXXX XX XXX XXXXXXXXXXXX XXXXXX XXX XXXXXXX XXX XX
XX                XXX                                      X
XX XXXXXXXXXXX XX XXX XXXXXXXXXXXXXX   XX XXX XXXXXXXXXXXXXX
XX XXXXXXXXXXX XX XXX XXXXXXXXXXXXXXX XXX XXX XXXXXXXXXXXXXX
XX XXXXXXXXXXX XX XXX XXXXXXXXXXXXXXX XXX XXX XXXXXXXXXXXXXX
X3                                                         X
XX XX XXXXXXXX XXX XX XXX XXX XXXXXXX XXXXXXXXXXXXXXX XXX XX
XX XX XXXXXXXX XXX XX XXX XXX XXXXXXX XXXXXXXXXXXXXXX XXX XX
XX XX XXXXXXXX XXX XX XXX XXX  XXXXXX XXXXXXXXXXXXXXX XXX XX
X  XX XXXXXXXX XXX XX                                     XX
X  XX XXXXXXXX XXX XX XXX XXX  XXXXXX XXXX XXX XX XXX XXX XX
X  XX XXXXXXXX XXX XX XXX XXX XXXXXXX XXXX XXX XX XXX XXX XX
XX XX XXXXXXXX XXX XX XXX XXX XXXXXXX XXXX XXX XX XXX XXX XX
XX XX XXXXXXXX XXX XX XXX XXX                             XX
XX XX              XX XXX XXX XXXX XX XXXX XXX XX XXXXXXX XX
XX XX XXXXXXXX XXX XX XXX XXX XXXX XX XXXX XXX XX XXXXXXX XX
XX XX XXXXXXXX XXX XX XXX XXX XXXX XX XXXX XXX XX XXXXXXX XX
XX XX XXXXXXXX XXX XX XXX XXX XXXT  X XXXX XXX XX XXXXXXX XX
XX             XXX XX                                      X
XX XX XXXXXXXX XXX XX XXXXXXX XXXXXXX XXXXXXXXXXXXXXXXXXX XX
XX XX XXXXXXXX XXX XX XXXXXXX XXXXXXX XXXXXXXXXXXXXXXXXXX XX
XX             XXX XX XXXXXXX XXXXXXX XXXXXXXXXXXXXXXXXXX XX
XX XX XXXXXXXX XXX XX                                      X
XX XX XXXXXXXX XXX XX XXXXXXXXXXXXXXX XXX XXX XXXXXXXXXXXXXX
X  XX XXXXXXXX XXX XX  XXXXXXXXXXXXXX XXX XXX  XXXXXXXXXXXXX
X  XX XXXXXXXX XXX XX                 XXX XXX              X
X                      XXXXXXXXXX   X XXX XXX  X   XXXXXXXXX
XXXXX  XXXXXXX XXX XX XXXXXXXXXXXX XX XXX XXX XXX XXXXXXXXXX
XXXXXX XXXXXXX XXX XX  XXXXXXXXXXX XX XXX XXX XXX XXXXXXXXXX
XXXXXX XXXXXXX XXX XX   XXXXXXXXXX XX XXX XXX XXX XXXXXXXXXX
XXXXXX XXXXXXX XXX XX                     XXX XXX XXXXXXXXXX
XXXXXX XXXXXXX XXX XX XXXXXXXXXXXXXXX XXX XXX XXX XXXXXXXXXX
XXXXXX XXXXXXX XXX XX XXXXXXXXXXXXXXX XXX XXX XXX XXXXXXXXXX
XXXXXX XXXXXXX XXX XX XXXXXXXXXXXXXXX XXX XXX XXX XXXXXXXXXX
X                     XXXXXXXXXXXXXXX XXX XXX XXX XXXXXXXXXX
XXXXXX XXXXXXX XXX XX XXXXXXXXXXXXXXX XXX XXX XXX XXXXXXXXXX
XXXXXX XXXXXXX XXX XX XXXXXXXXXXXXXXX XXX XXX XXX XXXXXXXXXX
XXXXXX XXXXXXX XXX XX XXXXXXXXXXXXXXX XXX XXX XXX XXXXXXXXXX
XXXXXX XXXXXXX XXX XX XXXXXXXXXXXXXXX XXX XXX XXX XXXXXXXXXX
XXXXXX XXXXXXX XXX XX XXXXXXXXXXXXXXX XXX XXX XXX XXXXXXXXXX
XXXXXX XXXXXXX XXX XX XXXXXXXXXXXXXXX XXX XXX XXX XXXXXXXXXX
X                  XX XXXXXXXXXXXXXXX                      X
XXXXXXXXXXXXXXCXXX XX XXXXXXXXXXXXXXX   X XXX XXXXXXXXXXXXXX
XXXXXXXXXXXXXXXXXXXXXXXXXXXXXXXXXXXXXXXXXXXXXXXXXXXXXXXXXXXX
