XXXXXXXXXXXXXXXXXXXXXXXXXXXXXXXXXXXXXXXXXXXXXXXXXXXXXXXXXXXX
XAXXXXXXX  XX  XX XXX              XX XXX              XXXBX
X                 XXX   XX XXX XXX        XXX XXXXXXX      X
X XXX XXX  XX  XX XXX  XXX XXX XXX XX XXX XXX XXXXXXX  XXX X
X XXX XXX XXX  XX XXX XXXX XXX XX  XX XXX XXX XXXXXXX XXXX X
X XXX XXX      XX XXX              XX XXX                  X
X           X          XXX XX  XX  XX XXX XXX XX   XX XXX  X
X XXX XXX  XXX XX XXX XXXX XX XXXX XX XXX XXX XXX XXX XXX  X
X XXX XXX XXX  XX XXX XXXX XX  XXX XX XXX XXX XXX XXX XXX XX
X  XX XXX XX   XX XXX XXXX XX             XXX XXX XXX  X   X
X                     XXXX XX  XXX XX XXX XXX XXX XXX      X
XX XXXXXXXXXXX XX XXX XXXX XX XXXX XX XXX XXX XXX XXX  XX XX
XX XXXXXXXXXX  XX XXX  XXX XX XXXX XX XXX XXX XXX XXX XXX XX
XX      a      XX XXX   XX X  bXXX XX XX   X   XX XXX XXX XX
XX XXXXXX XXX  XX XXX                                 XXX XX
XX XXXXXX XXXX XX XXX XXXX XXX XXX XXXXXX  XX XXXXXXX XXX XX
XX XXXXXX XXXX XX XXX XXXX XXX XXX XXXXXX XXX XXXXXXX XXX XX
XX                                                         X
XX XXXXXX XXXX XX XXX XXXX XXX XXX X   XX XXX XXXXXXXXXXXXXX
XX XXXXXX XXXX XX XXX XXXX XXX XXX XX XXX XXX XXXXXXXXXXXXXX
XX XXXXXX XXXX XX XXX XXXX XXX XXX XX XXX XXX XXXXXXXXXXXXXX
X                                                          X
XX XX   XX XX   X  XX XXX   X XXXXXXX   XXXXXXXXX   X XXX XX
XX XX  XXX XXX XXX XX XXX  XX XXXXXXX  XXXXXXXXXXX XX XXX XX
XX XX XXXX XXX XX  XX XXX XXX  XXXXXX  XXXXXXXXXXX XX  XX XX
X          XXX     XX                                     XX
X   X XX   XXX XX  XX XX    X  XXXXXX  XXX XXX X   XX  XX XX
X  XX XXX  XXX XXX XX XXX  XX XXXXXXX XXXX XXX XX XXX XXX XX
XX XX XXXX XX  XXX XX  XX XXX XXXXXXX  XXX XXX XX XXX XXX XX
XX XX XXX       X          XX                             XX
XX XX               X  XX      XX   X  X   XXX XX   XX XX XX
XX XX XXXXXXXX XXX XX XXX  XX XXXX XX XXX  XXX XX  XXX XX XX
XX XX XXXXXXXX XXX XX XXX XXX  XXX XX XXXX XXX XX XXXX XX XX
X  XX  XXXXXXX XXX XX XXX XXX   X   X XXX  XX   X XXX   X XX
X              XXX XX                                      X
X  XX  XXXXXXX XXX XX XXXXXXX XXX XXX XXX XXX XXXXXXXX XX XX
XX XX XXXXXXXX XXX XX XXXXXXX XXX XXX XXX XXX XXXXXXXX XX XX
X              XXX XX XXXXXXX XXX XXX XXX XXX XXXXXXXX X   X
XX XX   XXXXXX XXX XX                                      X
XX XX  XXXXXXX XXX XX XXXXXXXXXXX XXX XXX XXX XXXX XXX XXX X
X  XX XXXXXXXX XXX XX  XXXXXXXXXX XXX XXX XXX  XXX XXX XXX X
X  XX XXXXXXX   XX XX                 XXX XXX              X
X                      XXXXX   XX   X XXX XXX  X   X   XXXXX
X XXX  XXXXXXX XXX XX XXXXXXX XXXX XX XXX XXX XXX XXX XXXXXX
X XXXX XXXXXXX XXX XX  XXXXXX XXXX XX XXX XXX XXX  XX XXXXXX
X XXXX XXXXXXX XXX      XXXXX XXXX XX XXX XXX XXX          X
X XXXX XXXXXXX XXX XX                     XXX XXX  XXXXXXX X
X XXXX XXXXXXX XXX XX XXXXXXXXXXXXXXX XXX XXX XXX XXXXXXXX X
X XXXX XXXXXXX XXX XX XXXXXXXXXXXXXXX XXX XXX XXX XXXXXXXX X
X XXXX XXXXXX   XX X                      XXX XXX XXXXXXXX X
X                     XXXX XXX XXXXXX XXX XXX XXX          X
X XXXX XX XXXX XXX XX XXXX XXX XXXXXX XXX XXX XXX XXXX XXX X
X XXXX XX XXXX XXX XX XXXX XXX XXXXXX XXX XXX XXX XXXX XX  X
X XXXX XX XXXX XXX     XXX XXX XXXXXX  XX  XX  XX          X
X XXXX XX XXXX XXX XX          XXXXXX             XXXX XX  X
X XXXX XX XXXX XXX XX XXXX XXX XXXXXX  XX  XX TXX XXXX XXX X
X XXXX XX XXXX XXX XX XXXX XXX XXXXXX XXX XXX XXX XXXX XXX X
X                  XX                                      X
XXXXX   XCXXXX XXX XX XXXXXXXX XXXXXX   X XXXcXXXXXXXXXXXXXX
XXXXXXXXXXXXXXXXXXXXXXXXXXXXXXXXXXXXXXXXXXXXXXXXXXXXXXXXXXXX
