XXXXXXXXXXXXXXXXXXXXXXXXXXXXXXXXXXXXXXXXXXXXXXXXXXXXXXXXXXXX
XAXXXXXXX XXXX XXBXXX              XXXXXX             XXXXXX
X                 XXX   XX XXXXXXX XXXXXX XXX XXXXXXX XXXXXX
X XXX XXX XXXX XX XXX  XXX XXXXXXX XXXXXX XXX XXXXXXX XXXXXX
X XXX XXX XXX  XX XXX XXXX XXXXXX  XXXXXX XXX XXXXXXX XXXXXX
X XXX XXX      XX XXX              XXXXXX                  X
X         XXX          XXXXXX XXX  XXXXXX XXXXXX   XX XXX  X
X XXX XXX XXXX XX XXX XXXXXXX XXXX XXXXXX XXXXXXX XXX XXX  X
X XXX XXX XXX  XX XXX XXXXXXX  XXX XXXXXX XXXXXXX XXX XXX XX
X  XX XXX XX   XX XXX XXXXXXX      XXXXXX XXXXXXX XXX  XX XX
X                     XXXXXXX  XXX XXXXXX XXXXXXX XXX     aX
XX XXXXXXXXXXX XX XXX XXXXXXX XXXX XXXXXX XXXXXXX XXX  XX XX
XX XXXXXXXXXXX XX XXX XXXXXXX XXXX XXXXXX XXXXXXX XXX XXX XX
XX XXXXXXXXXXX XX XXX XXXXXX   XXX XXXXX   XXXXXX XXX XXX XX
XX XXXXXXXXXXX XX XXX                                 XXX XX
XX XXXXXXXXXXX XX XXX XXXXXXXX XXX XXXXXX  XX XXXXXXX XXX XX
XX XXXXXXXXXXX XX XXX XXXXXXXX XXX XXXXXX XXX XXXXXXX XXX XX
XX                                                        cX
XX XXXXXXXXXXX XX XXX XXXXXXXX XXX X   XX XXX XXXXXXXXXXXXXX
XX XXXXXXXXXXX XX XXX XXXXXXXX XXX XX XXX XXX XXXXXXXXXXXXXX
XX XXXXXXXXXXX XX XXX XXXXXXXX XXX XX XXX XXX XXXXXXXXXXXXXX
Xb                                                        CX
XX XX XXXX XXX XXX XX XXX   X XXXXXXX XXXXXXXXXXX   X XXX XX
XX XX XXXX XXX XXX XX XXX TXX XXXXXXX XXXXXXXXXXXX XX XXX XX
XX XX XXXX XXX XXX XX XXX XXX  XXXXXX  XXXXXXXXXXX XX  XX XX
X          XXX XXX XX                                     XX
X  XX XXXX XXX XXX XX XX   XX  XXXXXX  XXX XXX XX XXX  XX XX
X  XX XXXX XXX XXX XX XXX XXX XXXXXXX XXXX XXX XX XXX XXX XX
XX XX XXXX XXX XXX XX  XX XXX XXXXXXX  XXX XXX XX XXX XXX XX
XX XX XXX   X   X          XX                             XX
XX XX              XX  XX      XXX XX  X   XXX XX   XXXXX XX
XX XX XXXXXXXX XXX XX XXX  XX XXXX XX XXX  XXX XX  XXXXXX XX
XX XX XXXXXXXX XXX XX XXX XXX  XXX XX XXXX XXX XX XXXXXXX XX
XX XX XXXXXXXX XXX XX XXX XXX   X   X XXXX XX  XX XXXXXXX XX
XX             XXX XX                                      X
XX XX XXXXXXXX XXX XX XXXXXXX XXX XXX XXX XXX XXXXXXXX XX XX
XX XX XXXXXXXX XXX XX XXXXXXX XXX XXX XXX XXX XXXXXXXX XX XX
X              XXX XX XXXXXXX XXX XXX XXX XXX XXXXXXXX XX  X
XX XX XXXXXXXX XXX XX                                      X
XX XX XXXXXXXX XXX XX XXXXXXXXXXX XXX XXX XXX XXXXXXXX XXX X
X  XX XXXXXXXX XXX XX  XXXXXXXXXX XXX XXX XXX  XXXXXXX XXX X
X  XX XXXXXXXX XXX XX                 XXX XXX              X
X                      XXXXXXXXXX   X XXX XXX  X   X   XXXXX
X XXX  XXXXXXX XXX XX XXXXXXXXXXXX XX XXX XXX XXX XXX XXXXXX
X XXXX XXXXXXX XXX XX  XXXXXXXXXXX XX XXX XXX XXX  XX XXXXXX
X XXXX XXXXXXX XXX      XXXXXXXXXX XX XXX XXX XXX          X
X XXXX XXXXXXX XXX XX                     XXX XXX  XXXXXXX X
X XXXX XXXXXXX XXX XX XXXXXXXXXXXXXXX XXX XXX XXX XXXXXXXX X
X XXXX XXXXXXX XXX XX XXXXXXXXXXXXXXX XXX XXX XXX XXXXXXXX X
X XXXX XXXXXX   XX X                      XXX XXX XXXXXXXX X
X                     XXXXXXXX XXXXXX XXX XXX XXX          X
X XXXX XX XXXX XXX XX XXXXXXXX XXXXXX XXX XXX XXX XXXX XXX X
X XXXX XX XXXX XXX XX XXXXXXXX XXXXXX XXX XXX XXX XXXX XXX X
X XXXX XX XXXX XXX XX XXXXXXXX XXXXXX XXX XXX  XX          X
X XXXX XX XXXX XXX XX XXXXXXXX XXXXXX             XXXX XXX X
X XXXX XX XXXX XXX XX XXXXXXXX XXXXXX XXX XXX  XX XXXX XXX X
X XXXX XX XXXX XXX XX XXXXXXXX XXXXXX XXX XXX XXX XXXX XXX X
X                  XX                                      X
XXXXXXXXX XXXX XXX XX XXXXXXXX XXXXXX   X XXX XXXXXXXXXXXXXX
XXXXXXXXXXXXXXXXXXXXXXXXXXXXXXXXXXXXXXXXXXXXXXXXXXXXXXXXXXXX
