XXXXXXXXXXXXXXXXXXXXXXXXXXXXXXXXXXXXXXXXXXXXXXXXXXXXXXXXXXXX
X     XXXXXXXXXXXXXXXXXXXXXXXXXXXX XX   XX XXXXXXXXXXXXXXXXX
XX XX                                                      X
XX XX XXXX XXXXXXXXXXX XXXXXXXXXXX XXXXXXX XXXXXXXXXXX XXXXX
XX XX XXXX XXXXXXXXXXX XXXXXXXXXXX XXXXXXX XXXXXXXXXXX XXXXX
XX XX XXXX XXXXXXXXXXX XXXXXXXXXXX XXXXXXX XXXXXXXXXXX XXXXX
X                                                          X
XX XX XXXX XXXXXXXXXXX XX XXXX XX XXXX XXXXXXXXXXXXXXX XXXXX
XX XX XXXX XXXXXXXXXXX XX XXXX XX XXXX XXXXXXXXXXXXXXX XXXXX
XX XX XXXX XXXXXXXXXXX XX XXXX XX                          X
XX XX XXXX XXXXXXXXXXX         XX XXXX XXXXXX XXXX XXXXXX  X
XX XX XXXX XXXXXXXXXXX XX XXXX XX XXXX XXXXXX XXXX XXXXXXX X
XX XX XXXX XXXXXXXXXXX XX XXXX XX XXXX XXXXXX XXXX XXXXXX  X
XX XX XXXX XXXXXXXXXXX XX XXXX XX                          X
XX XX XXXX                        XXXX XXXXXX XXXX XXXXXX XX
XX XX XXXX XXXXXXXXXXX XX XXXX XX XXXX XXXXXX XXXX XXXXXX XX
XX XX XXXX XXXXXXXXXXX XX XXXX XX XXXX XXXXXX XXXX XXXXXX XX
XX XX XXXX XXXXXXXXXXX XX XXXX XX XXXX XXXXXX XXXX XXXXXX XX
XX XX XXXX XXXXXXXXXXX XX XXXX XX XXXX XXXXXX XXXX XXXXXX XX
XX XX XXXX XXXXXXXXXXX XX XXXX XX XXXX XXXXXX XXXX XXXXXX XX
XX XX XXXX XXXXXXXXXXX XX XXXX XX XXXX XXXXXX XXXX XXXXXX XX
XX X                              XXXX XXXXXX XXXX XXXXXX XX
X     XX   X   XXXXX   XX XXXXXXX XXXX                     X
XX XX XXX XXX XXXXXXX XXX XXXXXXX XXXX XXXXXX XXXXXXXXXXXXXX
XX XX XXX XXX XXXXXXX XXX XXXXXXX XXXX XXXXXX XXXXXXXXXXXXXX
XX XX                                                      X
XX XX XXX XXXXXXXXXXXX XXXXXXXXXX XXXX XX XXXX XXXXXX XXX  X
XX XX XXX XXXXXXXXXXXX XXXXXXXXXX XXXX XX XXXX XXXXXX XXXX X
XX XX XXX XXXXXXXXXXXX XXXXXXXXXX XXXX XX XXXX XXXXXX XXXX X
XX XX XXX XXXXXXXXXXXX XXXXXXXXXX XXXX XX XXXX XXXXXX XXXX X
XX XX XXX XXXXXXXXXXXX XXXXXXXXXX XXXX XX XXXX XXXXXX XXXX X
XX XX XXX XXXXXXXXXXXX XXXXXXXXXX XXXX XX XXXX XXXXXX XXXX X
XX XX XXX XXXXXXXXXXXX XXXXXXXXXX XXXX XX XXXX XXXXXX XXXX X
XX XX XXX XXXXXXXXXXXX XXXXXXXXXX XXXX XX                  X
XX XX XXX XXXXXXXXXXXX XXXXXXXXXX         XXX  XXX XX XXX  X
XX XX XXX XXXXXXXXXXXX XXXXXXXXXX XXXX XX XXX XXXX XX XXXX X
X  XX XXX XXXXXXXXXXXX XXXXXXXXXX XXXX XX XXX XXXX XX XXXX X
X  XX  XX XXXXXXXXXXX   XXXXXXXXX XXXX XX XXX         XXXX X
X  XX                             XXXX XX XXX XXXX XX XXXX X
XX XX  XX XXXXXXXXXXXX XXXXXX XXX XXXX XX XXX XXXX XX XXXX X
XX XX XXX XXXXXXXXXXXX XXXXXX XXX XXXX XX XXX XXXX XX XXXX X
XX XX XXX XXXXXXXXXXXX XXXXXX XXX XXXX XX XXX XXXX         X
XX XX XXX XXXXXXXXXXXX XXXXXX XXX XXXX XX XXX XXXX XX XXXX X
XX XX XXX XXXXXXXXXXXX XXXXXX XXX XXXX XX XXX XXXX XX XXXX X
XX XX XXX XXXXXXXXXXXX XXXXXX XXX XXXX XX XXX XXXX XX XXXX X
XX XX XXX XXXXXXXXXXXX XXXXXX XXX XXXX XX                  X
X                             XXX XXXX XX XXX XXXX XX XXXX X
XX XX XXX XXXX XXXXXXX XXXXXX XXX XXXX XX XXX XXXX XX XXXX X
XX XX XXX XXXX XXXXXXX XXXXXX XXX XXXX XX XXX XXXX XX XXXX X
XX XX XXX  XXX XXXXXXX XXXXXX XXX XXXX XX XXX XXXX XX XXXX X
XX XX XXX                     XXX XXXX XX XXX         XXXX X
XX XX XXX  XXX XXXXXXXXXXXXXX XXX XXXX XX XXX XXXX XX XXXX X
XX XX XXX XXXX XXXXXXXXXXXXXX XXX XXXX XX XXX XXXX XX XXX  X
XX XX                                                      X
XX XX XXXXXXXXXXX   XXXXXX XX XXX XXXX XX XXX XXXXXXXX XX  X
XXTXX XXXXXXXXXXXX XXXXXXX XX XXX XXXX XX XXX XXXXXXXX XXX X
XX XX XXXXXXXXXXXX XXXXXXX XX XXX XXXX XX XXX XXXXXXXX XXX X
X     XXXXXXXXXXXX XXXXXXX XX XXX         XXX XXXXXXXX XXX X
XX XX XXXXXXXXXXXX            XXX XXXX XX                  X
XXXXXXXXXXXXXXXXXXXXXXXXXXXXXXXXXXXXXXXXXXXXXXXXXXXXXXXXXXXX