XXXXXXXX
Xa     X
X      X
XX XX  X
XB XX  X
X  TX  X
XA    bX
XXXXXXXX
