XXXXXXXX
Xa    TX
XX X  BX
XX XX XX
XA XX  X
X  XX  X
X  b   X
XXXXXXXX
