XXXXXXXX
XdAXXXDX
X   ETaX
X XXXX X
X XXXX X
Xb C eBX
X XXXXcX
XXXXXXXX