XXXXXXXX
Xa    TX
X      X
XX XX  X
XB XX  X
X   X  X
XA    bX
XXXXXXXX
