XXXXXXXX
XX XXaTX
XA     X
XX XXX X
XX XXX X
X b   BX
X  XXX X
XXXXXXXX