XXXXXXXX
X cXXXbX
XTEXXXBX
XX XXXaX
XXAXXXDX
XXdXXC X
X    e X
XXXXXXXX