XXXXXXXX
XABa D X
X XXX XX
X XXXCXX
X XXX  X
XTcXX eX
X   bdEX
XXXXXXXX