XXXXXXXX
X      X
X XXX XX
X XXX XX
X XXX XX
X XXX  X
X     TX
XXXXXXXX