XXXXXXXX
XA    aX
XX XXbXX
XX XX XX
X  XX XX
X  XX XX
X     BX
XXXXXXXX
